Query_ID	Query_length	Query_start	Query_end	Subject_ID	Subject_length	Subject_start	Subject_end	E_value	Percent_ID	Query_coverage	Percent_positive_ID	Gap_openings	Total_gaps	Bitscore	Raw_score
Dcitr00g01400.1.1	260	1	261	RSSA_DROME	259	1	260	3.50e-128	72.556	86	80.45	2	11	365	937
Dcitr00g01430.1.1	165	1	166	Q8IG93_DROME	167	475	642	6.92e-76	71.006	94	82.25	2	4	238	608
Dcitr00g01430.1.1	165	1	166	Q86NV8_DROME	167	1023	1190	5.08e-74	71.006	94	82.25	2	4	240	612
Dcitr00g01430.1.1	165	1	166	Q9VF02_DROME	167	1725	1892	6.09e-74	71.006	94	82.25	2	4	240	612
Dcitr00g01740.1.1	413	1	414	PGK_DROME	413	1	414	0.0	76.087	99	86.23	0	0	647	1669
Dcitr00g01860.1.1	145	1	146	Q9W0Q2_DROME	145	29	174	3.21e-92	82.877	97	90.41	0	0	264	675
Dcitr00g02010.1.1	185	1	186	ARL8_DROME	185	1	186	2.28e-123	86.559	99	94.09	0	0	345	884
Dcitr00g02440.1.1	230	29	259	PTP10_DROME	231	108	339	1.60e-106	71.121	85	81.03	1	1	338	867
Dcitr00g02500.1.1	174	1	175	Q960U8_DROME	174	384	558	5.61e-93	71.429	96	82.86	0	0	280	717
Dcitr00g02500.1.1	174	1	175	Q8ST50_DROME	174	384	558	5.80e-93	71.429	96	82.86	0	0	280	717
Dcitr00g02510.1.1	174	1	175	Q960U8_DROME	174	384	558	5.61e-93	71.429	96	82.86	0	0	280	717
Dcitr00g02510.1.1	174	1	175	Q8ST50_DROME	174	384	558	5.80e-93	71.429	96	82.86	0	0	280	717
Dcitr00g02560.1.1	61	839	900	MELT_DROME	61	915	976	7.37e-26	82.258	98	95.16	0	0	114	285
Dcitr00g03030.1.1	413	1	414	MCCB_DROME	430	80	510	0.0	71.462	99	81.90	4	17	632	1629
Dcitr00g03250.1.1	160	1	161	Q9V4B2_DROME	161	1	162	1.05e-76	70.370	98	80.86	1	1	232	592
Dcitr00g03250.1.2	160	1	161	Q9V4B2_DROME	161	1	162	1.05e-76	70.370	98	80.86	1	1	232	592
Dcitr00g03310.1.1	159	1	160	SAN_DROME	160	1	161	2.27e-98	81.366	95	90.68	1	1	281	718
Dcitr00g03470.1.1	152	315	467	PTRO_DROME	149	1481	1630	3.09e-72	71.242	88	84.31	1	3	248	632
Dcitr00g03470.1.2	152	339	491	PTRO_DROME	149	1481	1630	7.20e-72	71.242	84	84.31	1	3	247	631
Dcitr00g03470.1.3	152	407	559	PTRO_DROME	149	1481	1630	3.93e-71	71.242	78	84.31	1	3	248	632
Dcitr00g03920.1.1	522	174	696	O61360_DROME	521	207	728	0.0	72.137	75	84.92	2	3	826	2133
Dcitr00g03920.1.1	480	174	654	O61361_DROME	479	207	686	0.0	73.651	75	86.10	2	3	779	2012
Dcitr00g04390.1.1	241	7	248	CSK2A_DROME	241	4	245	7.65e-125	75.207	95	85.95	0	0	357	916
Dcitr00g04530.1.1	65	2	67	Q4R0P9_DROME	65	285	350	2.80e-35	77.273	74	89.39	0	0	123	308
Dcitr00g04530.1.1	65	2	67	Q9VPQ5_DROME	65	285	350	5.12e-35	77.273	74	89.39	0	0	122	306
Dcitr00g04530.1.1	65	2	67	Q95R58_DROME	65	204	269	2.81e-34	77.273	74	89.39	0	0	119	298
Dcitr00g04580.1.1	252	42	294	SDHB_DROME	255	41	296	1.88e-147	77.432	86	83.27	3	5	415	1066
Dcitr00g04800.1.1	182	2	184	ADHX_DROME	182	5	187	2.06e-101	76.503	94	85.79	0	0	296	759
Dcitr00g04870.1.1	68	3	71	TPM1_DROME	68	219	287	7.00e-32	86.957	73	89.86	0	0	113	282
Dcitr00g04870.1.1	68	3	71	TPM4_DROME	68	165	233	7.17e-31	86.957	78	89.86	0	0	112	280
Dcitr00g04950.1.1	135	1	136	H33_DROME	135	1	136	1.09e-96	100.000	99	100.00	0	0	273	699
Dcitr00g04950.1.1	135	1	136	H3_DROME	135	1	136	2.54e-94	97.059	99	99.26	0	0	267	683
Dcitr00g05200.1.1	126	1	127	Q9V4E0_DROME	126	342	468	3.61e-76	83.465	99	93.70	0	0	232	592
Dcitr00g05310.1.1	490	1	491	SARM1_DROME	479	528	1007	0.0	70.732	97	82.32	4	13	733	1893
Dcitr00g05370.1.1	128	28	156	Q7JZW2_DROME	128	20	148	1.95e-70	71.318	82	88.37	0	0	208	530
Dcitr00g05370.1.1	128	28	156	A1ZAH8_DROME	128	19	147	2.08e-70	71.318	82	88.37	0	0	208	530
Dcitr00g05410.1.1	131	1	132	Q9VXK7_DROME	131	90	221	3.50e-84	81.818	99	93.18	0	0	244	624
Dcitr00g05410.1.1	131	1	132	Q9VAK5_DROME	131	81	212	8.63e-83	81.818	99	92.42	0	0	241	614
Dcitr00g05610.1.1	58	15	73	Q9V3I2_DROME	58	25	83	1.41e-22	71.186	80	81.36	0	0	85.5	210
Dcitr00g05800.1.1	173	5	178	ARF6_DROME	173	1	174	2.19e-102	77.011	95	88.51	0	0	291	745
Dcitr00g05950.1.1	160	1	161	Q9V4B2_DROME	161	1	162	1.05e-76	70.370	98	80.86	1	1	232	592
Dcitr00g06350.1.1	67	229	296	E1JGN7_DROME	67	421	488	9.07e-19	79.412	71	88.24	0	0	85.9	211
Dcitr00g06350.1.1	67	229	296	Q9V948_DROME	67	418	485	7.67e-19	79.412	71	88.24	0	0	85.9	211
Dcitr00g06350.1.1	71	229	300	A1ZBW0_DROME	71	427	498	5.56e-21	80.556	73	87.50	0	0	92.0	227
Dcitr00g06460.1.1	556	2	558	G6PI_DROME	554	1	555	0.0	72.172	99	81.33	2	2	827	2135
Dcitr00g06810.1.1	435	1	436	SC6A4_DROME	436	153	589	0.0	78.082	98	89.50	2	3	712	1839
Dcitr00g07000.1.1	223	1	224	Q86P76_DROME	223	309	532	3.71e-113	70.982	75	81.25	0	0	339	870
Dcitr00g07000.1.1	223	1	224	Q9VQC0_DROME	223	309	532	4.31e-113	70.982	75	81.25	0	0	339	870
Dcitr00g07120.1.1	153	1	154	Q7K738_DROME	153	1	154	9.10e-97	82.468	99	93.51	0	0	275	703
Dcitr00g07570.1.1	209	36	245	MOB4_DROME	209	1	210	5.40e-139	84.762	79	92.38	0	0	389	1000
Dcitr00g07570.1.2	177	1	178	MOB4_DROME	177	33	210	7.82e-117	85.393	89	92.70	0	0	330	846
Dcitr00g07570.1.3	209	1	210	MOB4_DROME	209	1	210	3.39e-139	84.762	91	92.38	0	0	388	997
Dcitr00g07580.1.1	303	1	304	RL5_DROME	296	1	297	1.19e-166	72.368	99	82.57	1	7	464	1193
Dcitr00g07660.1.1	61	7	68	PDE4C_DROME	59	312	371	1.86e-26	85.484	90	87.10	2	2	99.4	246
Dcitr00g07660.1.1	59	7	66	PDE4B_DROME	57	386	443	3.34e-26	86.667	87	88.33	2	2	98.6	244
Dcitr00g07660.1.1	59	7	66	PDE4A_DROME	57	525	582	4.06e-26	86.667	87	88.33	2	2	98.6	244
Dcitr00g08430.1.1	133	1	134	Q1HQ70_BOMMO	133	1	134	2.67e-82	83.582	89	91.04	0	0	239	611
Dcitr00g08430.1.1	144	1	145	Q9VZI1_DROME	140	1	141	2.29e-74	73.793	97	83.45	1	4	219	559
Dcitr00g08430.1.1	129	16	145	M9PE30_DROME	125	3	128	1.75e-63	71.538	87	81.54	1	4	191	486
Dcitr00g08770.1.1	127	1	128	RL40_DROME	127	1	128	4.51e-81	87.500	99	93.75	0	0	233	595
Dcitr00g08900.1.1	306	1	307	U520_DROME	306	423	729	0.0	84.691	100	93.16	0	0	556	1434
Dcitr00g08910.1.1	112	1	113	U520_DROME	112	741	853	8.69e-68	90.265	100	97.35	0	0	219	558
Dcitr00g08980.1.1	99	10	109	TREA_DROME	99	178	277	1.59e-45	72.000	80	83.00	0	0	154	390
Dcitr00g09100.1.1	112	3	115	MED31_DROME	112	8	120	3.86e-64	76.991	75	87.61	0	0	194	493
Dcitr00g09190.1.1	244	9	253	Q86NW1_DROME	244	299	543	3.24e-145	82.041	97	93.47	0	0	419	1076
Dcitr00g09190.1.1	244	9	253	Q8IGS0_DROME	244	299	543	3.45e-145	82.041	97	93.47	0	0	419	1076
Dcitr00g09190.1.1	244	9	253	Q8IH57_DROME	244	299	543	1.19e-144	82.041	97	93.47	0	0	418	1075
Dcitr00g09220.1.1	108	12	120	PABP_DROME	108	1	109	4.01e-62	84.404	91	94.50	0	0	199	506
Dcitr00g09250.1.1	164	5	169	Q9VCY6_DROME	164	89	253	2.53e-92	73.333	76	87.27	0	0	271	694
Dcitr00g09260.1.1	170	1	171	TCTP_DROME	170	1	171	3.59e-98	78.363	99	89.47	0	0	280	716
Dcitr00g09310.1.1	372	2	374	ADHX_DROME	374	5	379	0.0	70.133	99	82.40	2	2	563	1451
Dcitr00g09470.1.1	91	11	102	H4_DROME	91	11	102	2.63e-53	95.652	88	98.91	0	0	161	407
Dcitr00g09470.1.1	91	11	102	H4_LITVA	91	11	102	1.35e-50	92.391	88	95.65	0	0	154	389
Dcitr00g09480.1.1	136	1	137	H3_DROME	134	1	135	7.25e-88	92.701	99	94.89	1	2	251	641
Dcitr00g09480.1.1	136	1	137	H33_DROME	134	1	135	2.63e-85	89.781	99	94.16	1	2	244	624
Dcitr00g09690.1.1	107	1	108	MED11_DROME	107	4	111	1.35e-53	73.148	86	86.11	0	0	165	418
Dcitr00g09970.1.1	146	2	148	SERR_DROME	146	200	346	1.34e-73	70.068	99	82.99	0	0	238	606
Dcitr00g10040.1.1	580	5	585	KLHDB_DROME	581	39	620	0.0	89.003	96	95.53	1	1	1068	2762
Dcitr00g10040.1.2	574	5	579	KLHDB_DROME	574	39	613	0.0	90.087	98	96.00	0	0	1072	2772
Dcitr00g10120.1.1	44	23	67	M9MRZ0_DROME	44	338	382	6.11e-17	75.556	72	82.22	0	0	72.0	175
Dcitr00g10120.1.1	44	23	67	M9PI52_DROME	44	359	403	6.23e-17	75.556	72	82.22	0	0	72.0	175
Dcitr00g10160.1.1	355	14	369	PTP10_DROME	356	1192	1548	0.0	79.888	94	88.55	3	3	607	1565
Dcitr00g10160.1.1	330	49	379	E1JJE4_DROME	331	1284	1615	6.18e-173	72.372	87	86.19	3	3	522	1345
Dcitr00g10160.1.1	320	49	369	Q8IRS0_DROME	321	1284	1605	2.51e-166	72.136	84	85.76	3	3	504	1299
Dcitr00g10680.1.1	91	11	102	H4_DROME	91	11	102	2.63e-53	95.652	88	98.91	0	0	161	407
Dcitr00g10680.1.1	91	11	102	H4_LITVA	91	11	102	1.35e-50	92.391	88	95.65	0	0	154	389
Dcitr00g10960.1.1	572	1	573	Q9XZ53_DROME	565	206	771	0.0	72.822	99	83.62	3	9	858	2217
Dcitr00g10960.1.1	572	1	573	Q7KN63_DROME	565	229	794	0.0	72.822	99	83.62	3	9	857	2215
Dcitr00g11000.1.1	362	1	363	UBIQP_DROME	362	1	363	0.0	93.939	97	96.69	0	0	681	1756
Dcitr00g11000.1.1	362	1	363	UBIQP_DROME	362	77	439	0.0	93.939	97	96.69	0	0	681	1756
Dcitr00g11000.1.1	362	1	363	UBIQP_DROME	362	153	515	0.0	93.939	97	96.69	0	0	681	1756
Dcitr00g11000.1.1	362	1	363	UBIQP_DROME	362	229	591	0.0	93.939	97	96.69	0	0	681	1756
Dcitr00g11000.1.1	362	1	363	UBIQP_DROME	362	305	667	0.0	93.939	97	96.69	0	0	681	1756
Dcitr00g11000.1.1	362	1	363	UBIQP_DROME	362	381	743	0.0	93.939	97	96.69	0	0	681	1756
Dcitr00g11000.1.1	306	1	307	UBIQP_DROME	306	457	763	0.0	93.485	97	96.42	0	0	573	1478
Dcitr00g11000.1.1	362	1	363	Q9W418_DROME	362	1	363	0.0	93.939	97	96.69	0	0	680	1754
Dcitr00g11000.1.1	362	1	363	Q9W418_DROME	362	77	439	0.0	93.939	97	96.69	0	0	680	1754
Dcitr00g11000.1.1	362	1	363	Q9W418_DROME	362	153	515	0.0	93.939	97	96.69	0	0	680	1754
Dcitr00g11000.1.1	303	1	304	Q9W418_DROME	303	229	532	0.0	94.079	97	96.71	0	0	570	1470
Dcitr00g11000.1.1	303	1	304	Q8MT02_DROME	303	1	304	0.0	94.079	97	96.71	0	0	572	1473
Dcitr00g11000.1.1	286	77	363	Q8MT02_DROME	286	1	287	0.0	94.077	97	96.52	0	0	539	1389
Dcitr00g11040.1.1	348	2	350	ADHX_DROME	350	5	355	0.0	72.080	95	83.48	2	2	538	1385
Dcitr00g11040.1.2	348	2	350	ADHX_DROME	350	5	355	0.0	72.080	95	83.48	2	2	538	1385
Dcitr00g11230.1.1	124	1	125	ARL8_DROME	124	49	173	9.40e-82	88.000	87	94.40	0	0	238	606
Dcitr00g11380.1.1	289	2	291	C1TC_DROME	290	29	319	9.18e-143	72.165	90	83.51	1	1	426	1095
Dcitr00g11390.1.1	116	2	118	BRC1_DROME	116	1	117	5.36e-68	84.615	79	92.31	0	0	218	554
Dcitr00g11390.1.1	120	2	122	BRC4_DROME	120	1	121	2.30e-67	81.818	81	90.08	0	0	218	555
Dcitr00g11390.1.2	116	2	118	BRC1_DROME	116	1	117	5.36e-68	84.615	79	92.31	0	0	218	554
Dcitr00g11390.1.2	120	2	122	BRC4_DROME	120	1	121	2.30e-67	81.818	81	90.08	0	0	218	555
Dcitr00g11630.1.1	606	7	613	HSP7D_DROME	605	6	611	0.0	75.822	94	87.17	2	3	967	2499
Dcitr00g11700.1.1	305	1	306	SHAKB_DROME	307	59	366	8.93e-164	74.675	99	84.42	1	2	459	1182
Dcitr00g11950.1.1	165	12	177	Q9VV89_DROME	165	9	174	1.02e-96	78.916	93	92.77	0	0	276	707
Dcitr00g11950.1.1	162	15	177	Q8IQP2_DROME	162	1	163	1.42e-94	78.528	92	92.64	0	0	271	692
Dcitr00g11950.1.1	151	12	163	Q8IQP1_DROME	151	9	160	6.28e-87	78.947	85	92.76	0	0	251	642
Dcitr00g12020.1.1	513	5	518	KLHDB_DROME	513	39	552	0.0	90.078	99	95.72	0	0	950	2456
Dcitr00g12090.1.1	119	25	144	G6PD_DROME	119	167	286	1.93e-69	82.500	83	90.83	0	0	217	552
Dcitr00g12260.1.1	495	1	496	HSP7D_DROME	490	122	612	0.0	88.710	93	95.16	1	5	914	2361
Dcitr00g12260.1.1	530	1	531	HSP75_DROME	522	119	641	0.0	72.180	99	84.40	4	10	770	1988
Dcitr00g12260.1.1	530	1	531	HSP73_DROME	522	119	641	0.0	72.180	99	84.40	4	10	770	1988
Dcitr00g12420.1.1	921	11	932	Q9VVU6_DROME	922	9	931	0.0	79.198	99	89.60	1	1	1547	4006
Dcitr00g12480.1.1	138	7	145	PKN_DROME	139	432	571	1.06e-75	82.857	75	90.00	1	1	245	625
Dcitr00g12590.1.1	260	1	261	RSSA_DROME	259	1	260	6.75e-128	72.556	82	80.45	2	11	365	937
Dcitr00g12620.1.1	921	11	932	Q9VVU6_DROME	922	9	931	0.0	79.198	99	89.60	1	1	1547	4006
Dcitr00g12710.1.1	220	5	225	KLHDB_DROME	220	39	259	6.92e-139	85.973	97	93.67	0	0	402	1032
Dcitr00g12750.1.1	148	19	167	Q9W414_DROME	148	106	254	3.22e-87	81.879	87	90.60	0	0	260	665
Dcitr00g12750.1.1	148	19	167	Q8SZ19_DROME	148	106	254	3.59e-87	81.879	87	90.60	0	0	260	664
Dcitr00g12750.1.1	148	19	167	Q9U7A2_DROME	148	99	247	1.14e-86	81.879	87	89.93	0	0	258	660
Dcitr00g13060.1.1	198	11	209	RS5A_DROME	195	33	228	1.78e-103	70.149	95	82.09	2	7	297	760
Dcitr00g13080.1.1	190	1	191	RAS1_DROME	188	1	189	1.66e-103	80.628	99	89.01	1	2	295	755
Dcitr00g13200.1.1	353	1	354	128UP_DROME	354	1	355	0.0	88.169	99	95.21	1	1	640	1651
Dcitr00g13250.1.1	137	1	138	O96880_DROME	137	50	187	4.21e-78	81.159	84	89.13	0	0	238	606
Dcitr00g13300.1.1	446	20	466	Q9V4E0_DROME	447	21	468	0.0	78.125	96	88.62	1	1	765	1975
Dcitr00g13360.1.1	55	4	59	A1A714_DROME	55	227	282	8.18e-20	76.786	77	91.07	0	0	80.5	197
Dcitr00g13360.1.1	55	4	59	Q960F6_DROME	55	227	282	1.11e-19	76.786	77	91.07	0	0	80.1	196
Dcitr00g13380.1.1	108	276	384	Q9VY72_DROME	113	1438	1551	4.73e-57	80.702	71	87.72	2	5	202	513
Dcitr00g13520.1.1	185	1	186	ARL8_DROME	185	1	186	2.28e-123	86.559	99	94.09	0	0	345	884
Dcitr00g13560.1.1	74	4	78	Q95NU8_DROME	74	486	560	3.72e-45	88.000	95	92.00	0	0	150	380
Dcitr00g13730.1.1	106	25	131	H2A_DROME	106	16	122	3.20e-61	81.308	76	92.52	0	0	183	465
Dcitr00g13730.1.1	105	26	131	H2A_LITVA	105	17	122	7.22e-61	81.132	75	92.45	0	0	182	463
Dcitr00g13760.1.1	265	150	415	Q9VM49_DROME	258	228	486	6.89e-130	72.556	82	81.95	2	7	386	991
Dcitr00g13760.1.2	265	150	415	Q9VM49_DROME	258	228	486	6.89e-130	72.556	82	81.95	2	7	386	991
Dcitr00g13880.1.1	230	1	231	IF4A3_DROME	230	169	399	3.49e-127	72.294	99	88.74	0	0	364	935
Dcitr00g13880.1.1	230	1	231	IF4A_DROME	230	173	403	3.80e-116	74.459	99	90.04	0	0	337	863
Dcitr00g14240.1.1	383	42	425	Q9VPU1_DROME	396	150	546	0.0	70.732	90	79.02	3	39	579	1492
Dcitr00g14240.1.1	383	42	425	Q24218_DROME	396	12	408	0.0	70.732	90	79.02	3	39	578	1490
Dcitr00g14240.1.1	383	42	425	Q8IPW2_DROME	396	12	408	0.0	70.732	90	79.02	3	39	577	1488
Dcitr00g14400.1.1	98	1	99	O96880_DROME	98	50	148	3.62e-53	80.808	93	89.90	0	0	171	432
Dcitr00g14500.1.1	209	8	217	Q9V3V6_DROME	211	4	215	1.93e-112	77.358	96	86.79	2	2	327	839
Dcitr00g14500.1.1	209	8	217	Q9XZC3_DROME	211	8	219	5.14e-110	75.943	96	85.38	2	2	321	823
Dcitr00g14670.1.1	95	2	97	Q8IGW7_DROME	97	4	101	4.84e-53	81.633	94	89.80	1	2	160	405
Dcitr00g14670.1.1	95	2	97	Q8IMX8_DROME	97	4	101	5.35e-53	81.633	94	89.80	1	2	160	405
Dcitr00g14840.1.1	136	1	137	X2JCM1_DROME	136	1176	1312	3.80e-76	81.022	97	91.24	0	0	244	624
Dcitr00g14840.1.1	136	1	137	M9MRX4_DROME	136	1176	1312	8.75e-76	81.022	97	91.24	0	0	244	622
Dcitr00g14840.1.1	136	1	137	X2JGD3_DROME	136	1176	1312	1.02e-75	81.022	97	91.24	0	0	243	621
Dcitr00g14880.1.1	262	1	263	Q9VM49_DROME	255	335	590	2.62e-129	71.103	99	80.99	2	7	378	971
Dcitr00g15080.1.1	682	1	683	MCM3_DROME	674	1	675	0.0	72.222	88	85.67	3	10	1027	2656
Dcitr00g15080.1.1	682	1	683	X2JAI4_DROME	673	1	674	0.0	72.222	88	85.53	3	11	1027	2655
Dcitr00g15190.1.1	233	1	234	Q9V3V6_DROME	233	195	428	4.80e-168	97.009	99	97.44	0	0	469	1208
Dcitr00g15190.1.1	233	1	234	Q9XZC3_DROME	232	199	431	3.76e-164	95.726	99	97.01	1	1	459	1182
Dcitr00g15320.1.1	87	16	103	DOS_DROME	86	28	114	3.46e-38	70.455	85	81.82	1	1	143	360
Dcitr01g01040.1.1	324	19	343	KGP25_DROME	324	610	934	0.0	87.077	94	92.62	0	0	576	1484
Dcitr01g01040.1.1	324	19	343	KGP24_DROME	324	764	1088	0.0	87.077	94	92.62	0	0	574	1480
Dcitr01g01050.1.1	163	1	164	KGP25_DROME	163	655	818	3.30e-110	95.122	96	96.95	0	0	334	856
Dcitr01g01050.1.1	163	1	164	KGP24_DROME	163	809	972	2.82e-109	95.122	96	96.95	0	0	334	857
Dcitr01g01240.1.1	262	9	271	VATH_DROME	272	173	445	1.27e-150	73.993	96	86.45	1	10	428	1101
Dcitr01g01330.1.1	323	40	363	JNK_DROME	323	40	363	0.0	89.815	88	95.06	0	0	614	1584
Dcitr01g01330.1.1	21	1	22	JNK_DROME	21	198	219	1.41e-06	90.909	88	90.91	0	0	49.3	116
Dcitr01g01340.1.1	173	17	190	JNK_DROME	173	9	182	5.84e-114	89.080	90	94.83	0	0	328	841
Dcitr01g01380.1.1	194	1	195	Q7JWS8_DROME	194	1	195	7.31e-132	89.231	99	95.38	0	0	367	942
Dcitr01g01490.1.1	233	1	234	KAD2_DROME	230	1	231	1.44e-132	77.447	94	87.66	2	5	373	957
Dcitr01g01530.1.1	229	1	230	KAD2_DROME	230	1	231	1.90e-135	79.221	94	89.18	1	1	380	976
Dcitr01g01640.1.1	554	11	565	Q9VNX4_DROME	553	19	572	0.0	73.153	98	83.60	1	1	849	2193
Dcitr01g01640.1.1	554	11	565	Q8T3P0_DROME	553	19	572	0.0	73.153	98	83.60	1	1	848	2191
Dcitr01g01840.1.1	335	1	336	Q0E8E8_DROME	353	1	354	1.43e-173	71.751	98	80.79	1	18	485	1249
Dcitr01g01840.1.1	335	1	336	Q9XZE4_DROME	353	1	354	7.16e-173	71.469	98	80.51	1	18	483	1244
Dcitr01g02320.1.1	203	5	208	RPB1_DROME	200	6	206	3.66e-102	79.512	99	91.71	2	5	365	936
Dcitr01g02650.1.1	628	1	629	CRN_DROME	635	1	636	0.0	73.428	78	86.95	2	7	980	2533
Dcitr01g02650.1.1	597	610	1207	CRN_DROME	610	5	615	0.0	70.048	78	83.09	5	33	894	2311
Dcitr01g03190.1.1	331	1	332	G3P1_DROME	331	1	332	0.0	85.241	99	91.87	0	0	584	1505
Dcitr01g03190.1.1	331	1	332	G3P2_DROME	331	1	332	0.0	84.639	99	91.87	0	0	582	1501
Dcitr01g03200.1.1	331	1	332	G3P1_DROME	331	1	332	0.0	85.241	99	91.87	0	0	584	1505
Dcitr01g03200.1.1	331	1	332	G3P2_DROME	331	1	332	0.0	84.639	99	91.87	0	0	582	1501
Dcitr01g03310.1.1	595	6	601	NSF2_DROME	592	80	672	0.0	70.017	99	83.75	3	5	848	2190
Dcitr01g03340.1.1	89	15	104	MFAP1_DROME	89	386	475	8.81e-38	71.111	76	83.33	0	0	132	331
Dcitr01g03500.1.1	295	5	300	PP11_DROME	295	6	301	5.52e-177	77.703	95	87.16	0	0	491	1265
Dcitr01g03500.1.1	295	5	300	PP12_DROME	295	6	301	5.36e-176	77.027	95	86.82	0	0	488	1256
Dcitr01g03500.1.1	295	5	300	PP13_DROME	295	6	301	4.38e-174	75.676	95	86.49	0	0	483	1243
Dcitr01g03700.1.1	348	6	354	EXD_DROME	357	10	367	0.0	82.320	98	85.36	6	17	548	1413
Dcitr01g03720.1.1	348	6	354	EXD_DROME	357	10	367	0.0	82.320	98	85.36	6	17	548	1413
Dcitr01g04280.1.1	341	1	342	GBB1_DROME	339	1	340	0.0	90.351	99	95.61	1	2	645	1665
Dcitr01g04740.1.1	418	1	419	Q7KMQ0_DROME	419	1	420	0.0	90.521	91	95.02	2	5	783	2021
Dcitr01g04810.1.1	434	1	435	Q7KMQ0_DROME	432	1	433	0.0	92.644	99	96.32	1	2	833	2151
Dcitr01g04970.1.1	35	973	1008	M9PD90_DROME	36	1155	1191	3.55e-06	70.270	74	81.08	1	1	52.0	123
Dcitr01g04970.1.1	35	1440	1475	M9PD90_DROME	36	1155	1191	3.55e-06	70.270	74	81.08	1	1	52.0	123
Dcitr01g04970.1.1	35	973	1008	Q9VKG8_DROME	36	1156	1192	3.55e-06	70.270	74	81.08	1	1	52.0	123
Dcitr01g04970.1.1	35	1440	1475	Q9VKG8_DROME	36	1156	1192	3.55e-06	70.270	74	81.08	1	1	52.0	123
Dcitr01g05310.1.1	555	2	557	TCPA_DROME	555	1	556	0.0	81.475	99	91.01	0	0	935	2416
Dcitr01g05370.1.1	305	1	306	PP2A_DROME	308	1	309	0.0	93.851	99	97.41	1	3	613	1581
Dcitr01g05450.1.1	49	1	50	DLG1_DROME	49	1	50	2.59e-23	84.000	82	94.00	0	0	90.1	222
Dcitr01g05520.1.1	235	1	236	DLG1_DROME	222	748	970	2.55e-130	77.119	99	86.02	1	13	390	1002
Dcitr01g06040.1.1	156	2	158	M9NDD0_DROME	155	116	271	5.86e-76	70.701	98	78.98	1	1	227	578
Dcitr01g06040.1.1	156	2	158	M9ND06_DROME	155	202	357	3.20e-75	70.701	98	78.98	1	1	228	581
Dcitr01g06040.1.1	156	2	158	RIM2_DROME	155	209	364	4.12e-75	70.701	98	78.98	1	1	228	580
Dcitr01g06730.1.1	111	27	138	Q9VKA1_DROME	111	21	132	1.01e-63	72.321	72	87.50	0	0	191	486
Dcitr01g06730.1.1	111	27	138	Q8SZ82_DROME	111	21	132	2.70e-63	71.429	72	87.50	0	0	190	483
Dcitr01g06770.1.1	74	14	88	Q9VKA1_DROME	74	21	95	7.04e-41	74.667	82	89.33	0	0	131	329
Dcitr01g06770.1.1	74	14	88	Q8SZ82_DROME	74	21	95	7.11e-41	74.667	82	89.33	0	0	131	329
Dcitr01g06810.1.1	111	27	138	Q9VKA1_DROME	111	21	132	1.01e-63	72.321	72	87.50	0	0	191	486
Dcitr01g06810.1.1	111	27	138	Q8SZ82_DROME	111	21	132	2.70e-63	71.429	72	87.50	0	0	190	483
Dcitr01g06990.1.1	67	16	83	S61G2_DROME	67	1	68	1.07e-39	88.235	81	92.65	0	0	125	313
Dcitr01g07000.1.1	67	1	68	S61G2_DROME	67	1	68	2.93e-39	88.235	99	92.65	0	0	123	308
Dcitr01g07120.1.1	314	100	414	GBLP_DROME	315	2	317	0.0	85.443	75	90.19	1	1	558	1439
Dcitr01g07120.1.2	314	3	317	GBLP_DROME	315	2	317	0.0	85.443	98	90.19	1	1	556	1434
Dcitr01g07170.1.1	314	3	317	GBLP_DROME	315	2	317	0.0	85.443	98	90.19	1	1	556	1434
Dcitr01g07290.1.1	18	413	431	Q0KHQ3_DROME	18	527	545	0.076	84.211	81	89.47	0	0	35.0	79
Dcitr01g07290.1.1	18	413	431	R9PY33_DROME	18	532	550	0.075	84.211	79	89.47	0	0	35.0	79
Dcitr01g07290.1.1	18	413	431	M9PI08_DROME	18	532	550	0.079	84.211	81	89.47	0	0	35.0	79
Dcitr01g07320.1.1	536	7	543	Q8IMX1_DROME	536	31	567	0.0	71.667	99	85.37	3	6	832	2148
Dcitr01g07320.1.1	536	7	543	Q9VCB6_DROME	536	9	545	0.0	71.667	99	85.37	3	6	830	2145
Dcitr01g07320.1.1	536	7	543	Q7K112_DROME	536	16	552	0.0	71.667	99	85.37	3	6	830	2143
Dcitr01g07360.1.1	357	1	358	Q8MTZ5_DROME	357	209	566	0.0	75.900	99	87.26	3	6	583	1502
Dcitr01g07360.1.1	357	1	358	Q8IMX1_DROME	357	210	567	0.0	75.900	99	87.26	3	6	583	1502
Dcitr01g07360.1.1	357	1	358	Q9VCB6_DROME	357	188	545	0.0	75.900	99	87.26	3	6	583	1502
Dcitr01g07360.1.2	380	32	412	Q8IMX1_DROME	380	187	567	0.0	75.260	92	87.50	3	6	625	1612
Dcitr01g07360.1.2	380	32	412	Q8MTZ5_DROME	380	186	566	0.0	75.260	92	87.50	3	6	625	1611
Dcitr01g07360.1.2	380	32	412	Q9VCB6_DROME	380	165	545	0.0	75.260	92	87.50	3	6	625	1611
Dcitr01g07770.1.1	171	4	175	O61722_DROME	171	5	176	1.53e-93	71.512	98	87.79	0	0	268	686
Dcitr01g07770.1.1	171	4	175	Q95VY8_DROME	171	1	172	2.55e-93	71.512	98	87.79	0	0	268	684
Dcitr01g07770.1.1	172	3	175	Q7KPK2_DROME	174	4	178	4.69e-92	70.286	98	86.29	1	2	265	677
Dcitr01g07810.1.1	171	4	175	O61722_DROME	171	5	176	1.53e-93	71.512	98	87.79	0	0	268	686
Dcitr01g07810.1.1	171	4	175	Q95VY8_DROME	171	1	172	2.55e-93	71.512	98	87.79	0	0	268	684
Dcitr01g07810.1.1	172	3	175	Q7KPK2_DROME	174	4	178	4.69e-92	70.286	98	86.29	1	2	265	677
Dcitr01g07850.1.1	180	14	194	RL11_DROME	180	4	184	9.31e-119	88.950	93	93.37	0	0	333	855
Dcitr01g07860.1.1	180	11	191	RL11_DROME	180	4	184	5.50e-119	88.950	94	93.37	0	0	334	856
Dcitr01g07960.1.1	154	1	155	A4UZI0_DROME	154	1	155	2.11e-80	78.065	95	86.45	0	0	258	659
Dcitr01g07960.1.1	154	1	155	A1ZA18_DROME	154	1	155	2.17e-80	78.065	95	86.45	0	0	258	659
Dcitr01g07960.1.1	154	1	155	O01349_DROME	154	1	155	2.35e-80	78.065	95	86.45	0	0	258	658
Dcitr01g08170.1.1	118	12	130	A1Z8R0_DROME	118	39	157	6.80e-59	75.630	92	84.03	0	0	189	479
Dcitr01g08170.1.1	118	12	130	Q7YU38_DROME	118	39	157	7.25e-59	75.630	92	84.03	0	0	189	479
Dcitr01g08170.1.1	118	12	130	A1Z8R1_DROME	118	39	157	2.17e-57	75.630	92	84.03	0	0	190	483
Dcitr01g08180.1.1	237	1	238	A1Z8R0_DROME	237	1	238	7.19e-139	80.833	100	90.00	2	4	399	1024
Dcitr01g08180.1.1	237	1	238	Q7YU38_DROME	237	1	238	7.93e-139	80.833	100	90.00	2	4	398	1023
Dcitr01g08180.1.1	237	1	238	A1Z8R1_DROME	237	1	238	1.63e-134	80.833	100	90.00	2	4	402	1034
Dcitr01g08900.1.1	130	1	131	CSKP_DROME	130	768	898	3.04e-71	77.863	99	90.84	0	0	228	581
Dcitr01g08930.1.1	117	4	121	CSKP_DROME	117	1	118	1.14e-69	85.593	96	96.61	0	0	223	568
Dcitr01g08940.1.1	310	1	311	A0A0B4KFZ5_DROME	309	1	310	1.75e-176	75.884	87	87.46	1	1	495	1274
Dcitr01g08940.1.1	310	1	311	Q9VFS9_DROME	309	1	310	1.90e-176	75.884	87	87.46	1	1	495	1275
Dcitr01g08950.1.1	89	390	479	DHE3_DROME	89	473	562	4.73e-48	95.556	91	96.67	0	0	173	439
Dcitr01g08960.1.1	519	21	540	DHE3_DROME	535	27	562	0.0	84.142	96	91.42	2	16	947	2448
Dcitr01g09550.1.1	717	14	731	ADA17_DROME	717	6	723	0.0	71.448	96	81.38	7	14	1083	2801
Dcitr01g09600.1.1	156	62	218	B8A403_DROME	156	1	157	9.22e-107	93.631	72	98.09	0	0	303	776
Dcitr01g09600.1.1	155	62	217	Q9VCF4_DROME	155	1	156	1.01e-99	89.103	71	94.23	0	0	285	730
Dcitr01g09600.1.1	154	62	216	Q9GQM8_DROME	154	1	155	4.68e-99	89.032	71	94.19	0	0	284	726
Dcitr01g09650.1.1	123	1	124	Q76NQ3_DROME	123	810	933	4.15e-61	75.000	88	88.71	0	0	201	511
Dcitr01g09650.1.1	123	1	124	M9PCJ7_DROME	123	805	928	4.51e-61	75.000	88	88.71	0	0	201	510
Dcitr01g09650.1.1	123	1	124	Q9VL07_DROME	123	1007	1130	7.49e-61	75.000	88	88.71	0	0	201	510
Dcitr01g09660.1.1	160	1	161	Q9VL07_DROME	161	818	979	6.46e-90	76.687	99	86.50	2	3	283	723
Dcitr01g09660.1.1	160	1	161	M9MRG4_DROME	161	812	973	6.56e-90	76.687	99	86.50	2	3	283	723
Dcitr01g09660.1.1	160	1	161	M9PCJ7_DROME	161	616	777	1.09e-86	76.687	99	86.50	2	3	271	694
Dcitr01g09670.1.1	343	7	350	M9MRG4_DROME	329	741	1070	0.0	72.965	95	83.43	2	14	533	1372
Dcitr01g09670.1.1	343	7	350	M9PCJ7_DROME	329	545	874	0.0	72.965	95	83.43	2	14	532	1371
Dcitr01g09670.1.1	343	7	350	Q76NQ3_DROME	334	545	879	0.0	72.384	95	82.85	1	9	530	1365
Dcitr01g09670.1.2	297	7	304	M9PCJ7_DROME	283	545	828	7.52e-163	74.832	93	84.56	2	14	477	1227
Dcitr01g09670.1.2	297	7	304	Q76NQ3_DROME	288	545	833	6.64e-162	74.161	93	83.89	1	9	474	1221
Dcitr01g09670.1.2	297	7	304	M9MRG4_DROME	283	741	1024	7.17e-161	74.832	93	84.56	2	14	477	1228
Dcitr01g09720.1.1	503	576	1079	M9MRG4_DROME	488	636	1124	0.0	73.413	73	84.72	3	15	775	2002
Dcitr01g09720.1.1	503	576	1079	M9PCJ7_DROME	488	440	928	0.0	73.413	73	84.72	3	15	774	1999
Dcitr01g09720.1.1	503	576	1079	Q9VL07_DROME	493	637	1130	0.0	73.016	73	84.33	2	10	772	1994
Dcitr01g09770.1.1	899	11	910	Q9VAX8_DROME	933	42	975	0.0	77.861	99	86.10	2	36	1516	3924
Dcitr01g09780.1.1	925	279	1204	Q9VAX8_DROME	932	43	975	0.0	80.300	77	89.29	2	9	1575	4079
Dcitr01g09790.1.1	211	1	212	Q9VY78_DROME	211	48	259	1.92e-136	83.962	97	91.98	0	0	382	981
Dcitr01g09800.1.1	937	1	938	Q9VAX8_DROME	974	1	975	0.0	76.813	99	85.29	5	45	1550	4012
Dcitr01g09830.1.1	660	1	661	SDHA_DROME	660	1	661	0.0	77.492	99	86.25	2	2	1041	2692
Dcitr01g10410.1.1	95	1	96	LAP4_DROME	95	1	96	2.95e-55	86.458	85	93.75	0	0	183	465
Dcitr01g10430.1.1	487	1	488	LAP4_DROME	479	1	480	0.0	71.311	83	82.79	4	8	707	1824
Dcitr01g10430.1.2	487	1	488	LAP4_DROME	479	1	480	0.0	71.311	86	82.79	4	8	708	1827
Dcitr01g10520.1.1	610	6	616	APKC_DROME	578	28	606	0.0	75.041	99	82.54	4	36	906	2341
Dcitr01g11340.1.1	93	2	95	Q8IMX8_DROME	95	4	99	6.19e-51	81.250	71	89.58	1	2	156	395
Dcitr01g11340.1.1	93	2	95	Q8IGW7_DROME	95	4	99	6.39e-51	81.250	71	89.58	1	2	156	395
Dcitr01g11650.1.1	1085	1	1086	Q7KN85_DROME	1111	1	1112	0.0	76.101	99	84.91	6	28	1754	4542
Dcitr01g11820.1.1	220	1	221	RAB3_DROME	219	1	220	1.48e-143	87.838	99	92.34	3	3	399	1024
Dcitr01g12150.1.1	487	53	540	ATPB_DROME	465	37	502	0.0	89.959	90	93.03	1	22	875	2262
Dcitr01g12150.1.1	496	45	541	Q8T4C4_DROME	474	96	570	0.0	71.285	92	81.93	3	24	713	1841
Dcitr01g12610.1.1	274	95	369	S4W2D1_LOCMI	274	1	275	0.0	95.636	71	98.18	0	0	562	1449
Dcitr01g12610.1.1	279	90	369	Q32KD4_DROME	279	124	403	0.0	90.357	72	96.43	0	0	551	1419
Dcitr01g12610.1.1	279	90	369	Q7KY08_DROME	279	90	369	0.0	90.357	72	96.43	0	0	550	1418
Dcitr01g12630.1.1	858	75	933	S4W2D1_LOCMI	847	1	848	0.0	94.412	92	97.56	1	11	1714	4439
Dcitr01g12630.1.1	863	70	933	Q32KD4_DROME	860	124	984	0.0	91.349	93	96.08	2	9	1679	4348
Dcitr01g12630.1.1	863	70	933	Q7KY08_DROME	860	90	950	0.0	91.349	93	96.08	2	9	1677	4344
Dcitr01g12630.1.2	858	49	907	S4W2D1_LOCMI	847	1	848	0.0	94.412	95	97.56	1	11	1715	4442
Dcitr01g12630.1.2	863	44	907	Q7KY08_DROME	860	90	950	0.0	91.349	95	96.08	2	9	1679	4348
Dcitr01g12630.1.2	863	44	907	Q32KD4_DROME	860	124	984	0.0	91.349	95	96.08	2	9	1678	4345
Dcitr01g12670.1.1	664	1	665	S4W2D1_LOCMI	653	195	848	0.0	93.985	99	97.44	1	11	1323	3424
Dcitr01g12670.1.1	664	1	665	Q32KD4_DROME	661	323	984	0.0	91.916	99	96.11	2	9	1299	3362
Dcitr01g12670.1.1	664	1	665	Q7KY08_DROME	661	289	950	0.0	91.916	99	96.11	2	9	1298	3360
Dcitr01g13030.1.2	33	5	38	A0A0B4LHR8_DROME	33	172	205	1.47e-12	82.353	94	91.18	0	0	70.5	171
Dcitr01g13360.1.1	100	30	130	RPAB2_DROME	101	29	130	5.94e-49	75.490	77	86.27	1	1	152	384
Dcitr01g13400.1.1	64	6	70	Q9V4C9_DROME	64	491	555	1.89e-37	89.231	86	96.92	0	0	130	328
Dcitr01g13400.1.1	61	6	67	Q7K3X3_DROME	61	438	499	3.19e-37	91.935	82	98.39	0	0	130	327
Dcitr01g13400.1.1	61	6	67	Q7KQN5_DROME	61	491	552	4.40e-37	91.935	82	98.39	0	0	130	326
Dcitr01g13810.1.1	274	1	275	CAPZB_DROME	274	1	275	8.15e-177	84.364	99	90.55	0	0	487	1254
Dcitr01g13880.1.1	164	67	231	Q8IN49_DROME	164	636	800	3.24e-84	70.303	80	85.45	0	0	266	679
Dcitr01g13910.1.1	787	10	797	Q8IN49_DROME	789	11	800	0.0	74.810	98	87.09	1	2	1284	3322
Dcitr01g13920.1.1	355	5	360	A0A0B4KH24_DROME	374	55	429	0.0	70.899	98	83.86	3	25	564	1453
Dcitr01g13920.1.1	355	5	360	A0A0B4KGK8_DROME	374	13	387	0.0	70.899	98	83.86	3	25	563	1452
Dcitr01g13920.1.1	355	5	360	A0A0B4KH21_DROME	374	47	421	0.0	70.899	98	83.86	3	25	563	1450
Dcitr01g14170.1.1	159	1	160	IF5A_DROME	158	1	159	1.52e-96	81.875	99	91.25	1	1	275	703
Dcitr01g14350.1.1	159	1	160	IF5A_DROME	158	1	159	1.52e-96	81.875	99	91.25	1	1	275	703
Dcitr01g14530.1.1	297	1	298	Q0E924_DROME	298	1	299	1.40e-159	75.251	92	89.63	1	1	447	1149
Dcitr01g14530.1.1	295	1	296	A8DYI7_DROME	296	1	297	1.12e-158	75.421	91	89.56	1	1	445	1144
Dcitr01g14530.1.1	295	1	296	A8DYI6_DROME	296	1	297	4.87e-158	75.421	91	89.56	1	1	444	1143
Dcitr01g14740.1.1	107	1	108	X2J6D4_DROME	107	1	108	7.36e-67	84.259	99	92.59	0	0	196	497
Dcitr01g14740.1.1	107	1	108	CYC2_DROME	107	1	108	7.36e-67	84.259	99	92.59	0	0	196	497
Dcitr01g14790.1.1	329	5	334	CALR_DROME	340	6	346	0.0	71.848	95	82.40	1	11	512	1319
Dcitr01g14950.1.1	196	58	254	RL19_DROME	196	1	197	1.73e-110	83.756	77	91.88	0	0	316	809
Dcitr01g14960.1.1	429	1	430	TBB2_DROME	428	1	429	0.0	90.698	96	95.35	1	1	801	2070
Dcitr01g14960.1.1	444	1	445	TBB3_DROME	449	1	450	0.0	85.778	99	93.56	1	5	795	2052
Dcitr01g14960.1.1	410	20	430	A1ZBL0_DROME	409	29	438	0.0	93.187	92	96.84	1	1	781	2016
Dcitr01g15000.1.1	429	1	430	TBB2_DROME	428	1	429	0.0	90.698	96	95.35	1	1	801	2070
Dcitr01g15000.1.1	444	1	445	TBB3_DROME	449	1	450	0.0	85.778	99	93.56	1	5	795	2052
Dcitr01g15000.1.1	410	20	430	A1ZBL0_DROME	409	29	438	0.0	93.187	92	96.84	1	1	781	2016
Dcitr01g15040.1.1	192	1	193	RL19_DROME	192	1	193	1.05e-110	84.456	94	92.23	0	0	314	805
Dcitr01g15120.1.1	514	1	515	KCNAW_DROME	497	1	498	0.0	83.333	96	89.53	6	19	857	2213
Dcitr01g15160.1.1	193	1	194	KCNAW_DROME	193	135	328	2.17e-118	82.990	92	93.30	0	0	345	884
Dcitr01g15340.1.1	466	1	467	Q8IRQ5_DROME	466	1	467	0.0	74.732	78	86.72	0	0	742	1915
Dcitr01g15340.1.1	460	7	467	Q9W3X6_DROME	460	35	495	0.0	75.488	77	87.64	0	0	741	1914
Dcitr01g15340.1.1	460	7	467	Q8SXM1_DROME	460	35	495	0.0	75.488	77	87.64	0	0	740	1910
Dcitr01g15360.1.1	466	1	467	Q8IRQ5_DROME	466	1	467	0.0	74.732	71	86.94	0	0	742	1916
Dcitr01g15490.1.1	144	3	147	ARPC2_DROME	144	153	297	1.52e-80	78.621	76	84.83	0	0	241	614
Dcitr01g15490.1.2	144	3	147	ARPC2_DROME	144	153	297	2.37e-79	77.931	76	84.14	0	0	238	606
Dcitr01g15810.1.1	538	19	557	DDX18_DROME	532	145	677	0.0	72.593	96	84.26	4	8	802	2071
Dcitr01g15900.1.1	162	27	189	Q9Y0G0_DROME	161	305	466	2.80e-91	78.528	83	86.50	1	1	274	701
Dcitr01g15900.1.1	162	27	189	Q9V3H5_DROME	161	303	464	3.22e-91	78.528	83	86.50	1	1	274	700
Dcitr01g15900.1.2	123	1	124	Q9V3H5_DROME	122	342	464	3.43e-70	82.258	94	87.90	1	1	217	552
Dcitr01g15900.1.2	123	1	124	Q9Y0G0_DROME	122	344	466	3.60e-70	82.258	94	87.90	1	1	217	552
Dcitr01g16250.1.2	397	10	407	Q9W3N9_DROME	396	14	410	0.0	70.352	98	84.17	1	1	593	1530
Dcitr01g16460.1.1	207	3	210	RAB6_DROME	206	2	208	1.46e-148	95.673	99	97.60	1	1	410	1055
Dcitr01g16470.1.1	306	248	554	PSDE_DROME	303	1	304	0.0	88.925	85	94.46	1	3	570	1468
Dcitr01g16470.1.1	190	1	191	PSDE_DROME	187	1	188	1.55e-122	92.670	85	95.29	1	3	363	932
Dcitr01g16560.1.1	302	3	305	1433Z_DROME	246	2	248	1.83e-153	72.937	99	76.90	2	56	429	1102
Dcitr01g16570.1.1	779	5	784	PFKA_DROME	779	2	781	0.0	78.333	99	87.95	0	0	1247	3226
Dcitr01g16600.1.1	392	1	393	PFKA_DROME	392	389	781	0.0	78.372	99	87.28	0	0	611	1576
Dcitr01g16780.1.1	54	10	64	Q9VNP7_DROME	54	72	126	1.76e-24	74.545	85	90.91	0	0	93.6	231
Dcitr01g16810.1.1	52	1178	1230	RPB1_DROME	52	1073	1125	4.33e-16	71.698	85	84.91	0	0	83.6	205
Dcitr01g16810.1.2	52	1178	1230	RPB1_DROME	52	1073	1125	4.23e-16	71.698	85	84.91	0	0	83.6	205
Dcitr01g17040.1.1	318	796	1114	GALT5_DROME	318	304	622	0.0	77.743	89	86.21	0	0	554	1427
Dcitr01g17420.1.1	246	1	247	KCNAW_DROME	245	6	251	1.96e-139	72.470	99	86.23	1	1	400	1027
Dcitr01g17660.1.1	179	1	180	O96692_DROME	179	1	180	9.19e-92	77.348	97	85.08	2	2	265	676
Dcitr01g17660.1.2	179	1	180	O96692_DROME	179	1	180	9.19e-92	77.348	97	85.08	2	2	265	676
Dcitr01g17690.1.1	102	10	112	Q7JWH5_DROME	102	11	113	1.56e-60	82.524	91	87.38	0	0	180	457
Dcitr01g18290.1.1	96	15	111	Q9VJI7_DROME	97	13	110	1.92e-48	73.469	85	87.76	1	1	149	377
Dcitr01g18310.1.1	96	15	111	Q9VJI7_DROME	97	13	110	1.92e-48	73.469	85	87.76	1	1	149	377
Dcitr01g18470.1.1	98	1	99	GSB_DROME	98	1	99	3.02e-62	91.919	97	94.95	0	0	194	493
Dcitr01g18470.1.1	98	1	99	GSBN_DROME	99	1	100	1.11e-55	84.000	97	92.00	1	1	177	450
Dcitr01g18470.1.1	89	10	99	PRD_DROME	94	13	107	3.36e-49	82.105	88	88.42	1	5	163	413
Dcitr01g18660.1.1	333	6	339	Q8INQ9_DROME	333	13	346	0.0	82.036	98	90.42	0	0	584	1506
Dcitr01g18660.1.1	333	6	339	Q8INR0_DROME	333	10	343	0.0	82.036	98	90.42	0	0	582	1501
Dcitr01g18660.1.1	332	7	339	Q9XYA7_DROME	332	1	333	0.0	82.282	97	90.69	0	0	582	1499
Dcitr01g18700.1.1	130	8	138	RPB4_DROME	130	9	139	2.13e-76	82.443	94	89.31	0	0	222	566
Dcitr01g19080.1.1	108	1	109	RS26_DROME	107	1	108	2.33e-63	86.239	92	90.83	1	1	187	476
Dcitr01g19300.1.1	294	43	337	RFC2_DROME	294	13	307	3.44e-164	73.559	79	85.76	0	0	462	1188
Dcitr01g19340.1.1	98	12	110	RFC2_DROME	98	19	117	9.71e-51	77.778	83	86.87	0	0	162	411
Dcitr01g19380.1.1	106	9	115	Q9W0C1_DROME	107	17	124	1.70e-61	87.963	91	90.74	1	1	185	470
Dcitr01g19380.1.1	106	9	115	Q9W0C2_DROME	107	26	133	2.05e-61	87.963	91	90.74	1	1	185	470
Dcitr01g19380.1.1	103	9	112	M9PE71_DROME	104	17	121	2.24e-61	88.571	89	91.43	1	1	186	471
Dcitr01g19410.1.1	106	17	123	Q9W0C1_DROME	107	17	124	2.45e-61	87.963	86	90.74	1	1	185	470
Dcitr01g19410.1.1	106	17	123	Q9W0C2_DROME	107	26	133	2.51e-61	87.963	86	90.74	1	1	185	470
Dcitr01g19410.1.1	106	17	123	Q26335_DROSP	107	17	124	3.09e-61	87.963	86	90.74	1	1	185	469
Dcitr01g19440.1.1	118	1	119	Q9W2S2_DROME	118	1	119	1.98e-80	92.437	98	97.48	0	0	231	589
Dcitr01g19440.1.1	115	1	116	Q9VEG5_DROME	115	3	118	1.16e-68	79.310	96	93.10	0	0	201	511
Dcitr01g19440.1.1	115	1	116	Q7K1J3_DROME	115	41	156	3.07e-68	79.310	96	93.10	0	0	201	512
Dcitr01g19450.1.1	141	9	150	M9PE71_DROME	132	17	149	6.01e-62	72.028	90	76.22	2	11	189	479
Dcitr01g19460.1.1	89	8	97	X2JEE0_DROME	89	15	104	2.10e-60	92.222	90	97.78	0	0	179	454
Dcitr01g19460.1.1	92	5	97	X2JJA8_DROME	92	1	93	3.21e-60	90.323	93	95.70	0	0	178	451
Dcitr01g19460.1.1	91	6	97	Q9W2S2_DROME	91	27	118	4.35e-60	91.304	92	96.74	0	0	179	453
Dcitr01g19480.1.1	279	3	282	GUS_DROME	277	1	278	7.88e-162	75.618	98	85.87	3	8	450	1158
Dcitr01g19610.1.1	375	1	376	ACT6_DROME	375	1	376	0.0	98.138	99	99.47	0	0	778	2009
Dcitr01g19610.1.1	375	1	376	ACT5_DROME	375	1	376	0.0	98.404	99	99.47	0	0	778	2008
Dcitr01g19610.1.1	375	1	376	G3CKA6_SPOFR	375	1	376	0.0	98.138	99	99.47	0	0	776	2005
Dcitr01g19790.1.1	618	5	623	HSP68_DROME	633	2	635	0.0	76.814	99	88.49	1	15	1027	2655
Dcitr01g19790.1.1	618	5	623	HSP71_DROME	640	2	642	0.0	76.443	99	86.58	3	22	1014	2622
Dcitr01g19790.1.1	618	5	623	HSP70_DROME	640	2	642	0.0	76.443	99	86.58	3	22	1014	2622
Dcitr01g19810.1.1	413	1	414	HSP71_DROME	413	58	471	0.0	83.092	99	92.27	0	0	728	1880
Dcitr01g19810.1.1	413	1	414	HSP70_DROME	413	58	471	0.0	83.092	99	92.27	0	0	728	1880
Dcitr01g19810.1.1	413	1	414	HSP75_DROME	413	58	471	0.0	82.850	99	92.27	0	0	726	1875
Dcitr01g20400.1.1	181	1	182	MCTS1_DROME	181	1	182	7.08e-102	70.330	99	87.91	0	0	290	742
Dcitr01g20560.1.1	181	1	182	MCTS1_DROME	181	1	182	7.08e-102	70.330	99	87.91	0	0	290	742
Dcitr01g20680.1.1	220	2	222	Q7K519_DROME	216	131	347	1.30e-118	75.566	89	87.78	1	4	343	879
Dcitr01g20870.1.1	116	17	133	Q9VF56_DROME	116	804	920	3.58e-57	76.068	84	86.32	0	0	190	483
Dcitr01g20880.1.1	156	1	157	Q9VF56_DROME	156	556	712	1.48e-76	73.885	98	87.26	0	0	247	630
Dcitr01g21170.1.1	135	1	136	ANKHM_DROME	135	887	1022	1.43e-69	77.941	99	89.71	0	0	226	575
Dcitr01g21290.1.1	420	3	423	CAF1_DROME	420	6	426	0.0	93.112	98	97.15	0	0	823	2127
Dcitr01g21350.1.1	420	3	423	CAF1_DROME	420	6	426	0.0	93.112	98	97.15	0	0	823	2127
Dcitr01g21550.1.1	425	120	545	Q9VYU7_DROME	434	238	672	0.0	71.365	76	79.64	7	33	617	1592
Dcitr01g21550.1.1	425	120	545	Q24328_DROME	434	236	670	0.0	71.365	76	79.42	7	33	616	1589
Dcitr01g21770.1.1	425	120	545	Q9VYU7_DROME	434	238	672	0.0	71.365	76	79.64	7	33	617	1592
Dcitr01g21770.1.1	425	120	545	Q24328_DROME	434	236	670	0.0	71.365	76	79.42	7	33	616	1589
Dcitr01g22000.1.1	106	18	124	H2B_LITVA	103	13	116	9.74e-68	92.523	86	96.26	1	3	199	505
Dcitr01g22000.1.1	119	5	124	H2B_DROME	119	4	123	7.08e-64	94.167	96	98.33	0	0	189	481
Dcitr01g22000.1.2	79	129	208	H2B_LITVA	79	37	116	9.26e-52	96.250	80	100.00	0	0	162	409
Dcitr01g22000.1.2	86	18	104	H2B_LITVA	83	13	96	1.53e-50	89.655	80	94.25	1	3	159	401
Dcitr01g22000.1.2	79	129	208	H2B_DROME	79	44	123	2.45e-51	96.250	80	100.00	0	0	161	407
Dcitr01g22000.1.2	86	18	104	H2B_DROME	86	17	103	2.93e-46	93.103	80	97.70	0	0	148	374
Dcitr01g22100.1.1	515	4	519	PDE11_DROME	516	588	1104	0.0	81.238	96	90.91	1	1	905	2340
Dcitr01g22120.1.1	593	995	1588	PDE11_DROME	624	480	1104	0.0	75.840	88	85.28	2	31	999	2582
Dcitr01g22120.1.1	436	166	602	PDE11_DROME	437	480	917	0.0	81.507	88	90.87	1	1	771	1991
Dcitr01g22120.1.1	59	708	767	PDE11_DROME	57	392	449	4.89e-23	88.333	88	91.67	1	2	106	265
Dcitr01g22120.1.1	49	844	893	PDE11_DROME	49	457	506	3.95e-18	76.000	88	92.00	0	0	90.9	224
Dcitr01g22120.1.1	31	1	32	PDE11_DROME	31	475	506	1.41e-08	71.875	88	90.62	0	0	59.3	142
Dcitr01g22120.1.1	26	38	64	PDE11_DROME	26	480	506	1.84e-06	74.074	88	88.89	0	0	52.4	124
Dcitr01g22120.1.1	26	102	128	PDE11_DROME	26	480	506	1.84e-06	74.074	88	88.89	0	0	52.4	124
Dcitr01g22120.1.1	26	70	96	PDE11_DROME	26	480	506	3.07e-06	74.074	88	88.89	0	0	51.6	122
Dcitr01g22370.1.1	593	216	809	Q961E0_DROME	586	15	601	0.0	74.161	73	83.56	2	11	891	2302
Dcitr01g22410.1.1	472	12	484	Q5BI50_DROME	465	356	821	0.0	76.421	98	85.05	2	11	734	1894
Dcitr01g22410.1.1	472	12	484	Q961E0_DROME	465	136	601	0.0	76.421	98	85.05	2	11	728	1880
Dcitr01g22600.1.1	321	1	322	D1YSF9_DROME	315	602	917	4.14e-170	75.232	100	85.76	4	8	498	1281
Dcitr01g22600.1.1	321	1	322	Q9XZL6_DROME	315	574	889	8.18e-170	75.232	100	85.76	4	8	498	1282
Dcitr01g22600.1.1	321	1	322	Q9V4E5_DROME	315	635	950	2.24e-169	75.232	100	85.76	4	8	498	1283
Dcitr01g22640.1.1	222	3	225	Q8MT37_DROME	222	110	332	8.34e-127	77.130	99	88.34	0	0	380	976
Dcitr01g22640.1.1	222	3	225	Q5BIC7_DROME	222	77	299	1.59e-126	77.130	99	88.34	0	0	381	978
Dcitr01g22640.1.1	222	3	225	D1YSF9_DROME	222	77	299	1.32e-123	77.130	99	88.34	0	0	381	978
Dcitr01g22650.1.1	131	9	140	Q8MT37_DROME	131	112	243	3.01e-80	84.848	73	95.45	0	0	250	639
Dcitr01g22650.1.1	131	9	140	Q5BIC7_DROME	131	79	210	7.85e-80	84.848	73	95.45	0	0	250	639
Dcitr01g22650.1.1	134	9	143	O96435_DROME	134	51	185	9.69e-79	82.963	75	94.81	0	0	252	643
Dcitr01g22700.1.1	211	77	288	MOB1_DROME	211	6	217	6.50e-150	94.340	73	95.75	0	0	417	1073
Dcitr02g01310.1.1	351	353	704	NEDD4_DROME	336	505	841	2.69e-179	73.011	90	80.68	3	15	537	1383
Dcitr02g01310.1.2	351	309	660	NEDD4_DROME	336	505	841	1.79e-179	73.011	96	80.68	3	15	536	1380
Dcitr02g01390.1.1	184	3	187	P91634_DROME	186	816	1002	1.01e-91	73.404	89	85.64	2	4	289	740
Dcitr02g01530.1.1	95	1	96	VATC_DROME	95	2	97	1.15e-47	82.292	99	92.71	0	0	171	433
Dcitr02g01560.1.1	285	97	382	VATC_DROME	286	546	832	4.18e-163	77.700	99	89.55	1	1	478	1229
Dcitr02g01560.1.1	95	1	96	VATC_DROME	95	2	97	2.59e-47	82.292	99	92.71	0	0	171	434
Dcitr02g01560.1.2	285	97	382	VATC_DROME	286	546	832	4.18e-163	77.700	99	89.55	1	1	478	1229
Dcitr02g01560.1.2	95	1	96	VATC_DROME	95	2	97	2.59e-47	82.292	99	92.71	0	0	171	434
Dcitr02g01560.1.3	285	97	382	VATC_DROME	286	546	832	4.18e-163	77.700	99	89.55	1	1	478	1229
Dcitr02g01560.1.3	95	1	96	VATC_DROME	95	2	97	2.59e-47	82.292	99	92.71	0	0	171	434
Dcitr02g01560.1.4	285	97	382	VATC_DROME	286	546	832	4.18e-163	77.700	99	89.55	1	1	478	1229
Dcitr02g01560.1.4	95	1	96	VATC_DROME	95	2	97	2.59e-47	82.292	99	92.71	0	0	171	434
Dcitr02g01560.1.5	285	97	382	VATC_DROME	286	546	832	4.18e-163	77.700	99	89.55	1	1	478	1229
Dcitr02g01560.1.5	95	1	96	VATC_DROME	95	2	97	2.59e-47	82.292	99	92.71	0	0	171	434
Dcitr02g01790.1.1	1484	30	1514	DUOX_DROME	1476	61	1537	0.0	75.084	98	86.30	7	16	2395	6207
Dcitr02g01870.1.1	171	1	172	Q704P7_9HEMI	171	1	172	1.21e-71	77.326	84	89.53	0	0	224	571
Dcitr02g01870.1.1	195	6	201	TNNI_DROME	197	67	264	7.76e-71	76.768	96	87.37	1	2	216	549
Dcitr02g01880.1.1	171	1	172	Q704P7_9HEMI	171	1	172	7.25e-72	77.326	86	89.53	0	0	224	572
Dcitr02g01880.1.1	186	6	192	TNNI_DROME	186	67	253	7.09e-71	78.610	93	89.84	0	0	216	549
Dcitr02g01910.1.1	574	57	631	A0A0B4KF15_DROME	573	622	1195	0.0	74.261	71	86.26	1	1	946	2446
Dcitr02g01910.1.1	574	57	631	A1Z7F4_DROME	573	302	875	0.0	74.261	71	86.26	1	1	945	2442
Dcitr02g01910.1.1	574	57	631	B7YZT0_DROME	573	622	1195	0.0	74.261	71	86.26	1	1	944	2441
Dcitr02g02020.1.1	57	492	549	Q86M30_DROME	57	670	727	4.49e-25	84.483	74	87.93	0	0	110	274
Dcitr02g02020.1.1	57	492	549	Q9VLT9_DROME	57	670	727	4.49e-25	84.483	74	87.93	0	0	110	274
Dcitr02g02020.1.1	57	492	549	M9NEC0_DROME	57	687	744	4.52e-25	84.483	74	87.93	0	0	110	274
Dcitr02g02360.1.1	519	14	533	Q9VK69_DROME	519	14	533	0.0	79.808	97	90.00	0	0	855	2210
Dcitr02g02380.1.1	508	14	522	Q9VK69_DROME	514	14	528	0.0	79.029	79	88.93	1	6	829	2141
Dcitr02g02380.1.1	301	630	931	Q9VK69_DROME	301	200	501	1.03e-169	80.132	79	89.40	0	0	509	1310
Dcitr02g02380.1.1	53	582	635	Q9VK69_DROME	53	36	89	5.00e-21	83.333	79	94.44	0	0	97.8	242
Dcitr02g02590.1.1	106	1	107	Q9VPR5_DROME	106	1197	1303	1.92e-69	90.654	100	97.20	0	0	224	570
Dcitr02g02700.1.1	128	42	170	SDHB_DROME	128	41	169	3.01e-72	78.462	73	85.38	2	2	219	557
Dcitr02g02870.1.1	310	3	313	A0A0B4LFW8_DROME	310	967	1277	4.28e-180	81.350	99	88.10	0	0	531	1367
Dcitr02g02870.1.1	310	3	313	A0A0B4LFP7_DROME	310	938	1248	4.88e-180	81.350	99	88.10	0	0	530	1364
Dcitr02g02870.1.1	310	3	313	Q7JUV6_DROME	310	1043	1353	1.10e-179	81.350	99	88.10	0	0	531	1369
Dcitr02g03250.1.1	419	1	420	PYG_DROME	420	1	421	0.0	81.948	99	90.74	1	1	707	1825
Dcitr02g03390.1.1	839	1	840	PYG_DROME	839	1	840	0.0	80.476	99	90.24	0	0	1410	3649
Dcitr02g04040.1.1	381	77	458	A1Z7F4_DROME	382	36	418	0.0	76.042	79	88.54	3	3	627	1617
Dcitr02g04040.1.1	355	103	458	A0A0B4KF15_DROME	355	383	738	0.0	80.112	79	92.16	2	2	622	1604
Dcitr02g04040.1.1	355	103	458	B7YZT0_DROME	355	383	738	0.0	80.112	79	92.16	2	2	621	1602
Dcitr02g04070.1.1	106	1	107	B7YZT0_DROME	106	516	622	1.05e-60	85.981	100	97.20	0	0	199	505
Dcitr02g04070.1.1	106	1	107	A0A0B4KF15_DROME	106	516	622	1.20e-60	85.981	100	97.20	0	0	199	505
Dcitr02g04070.1.1	106	1	107	A1Z7F4_DROME	106	196	302	1.61e-60	85.981	100	97.20	0	0	198	503
Dcitr02g04090.1.1	97	4	101	A1Z7F6_DROME	97	92	189	3.42e-50	74.490	91	86.73	0	0	168	425
Dcitr02g04090.1.1	97	4	101	Q70GQ8_DROME	97	384	481	6.08e-50	74.490	91	86.73	0	0	168	425
Dcitr02g04090.1.1	97	4	101	A1Z7F4_DROME	97	407	504	6.11e-50	74.490	91	86.73	0	0	168	425
Dcitr02g04330.1.1	618	1	619	CHD1_DROME	620	435	1055	0.0	74.240	99	85.76	5	10	964	2493
Dcitr02g04330.1.2	618	1	619	CHD1_DROME	620	435	1055	0.0	74.240	99	85.76	5	10	964	2493
Dcitr02g04340.1.1	104	1	105	Q8MLQ5_DROME	105	179	284	6.11e-39	75.472	77	82.08	1	1	155	393
Dcitr02g04340.1.1	104	1	105	Q9W1G5_DROME	105	164	269	5.63e-39	75.472	77	82.08	1	1	155	393
Dcitr02g04340.1.1	104	1	105	A0A0B4LHE0_DROME	105	171	276	5.63e-39	75.472	77	82.08	1	1	155	393
Dcitr02g04720.1.1	361	1	362	MCM4_DROME	374	483	857	1.91e-172	71.200	86	83.73	1	13	550	1417
Dcitr02g04770.1.1	427	45	472	TBB2_DROME	428	1	429	0.0	85.082	86	93.01	1	1	763	1970
Dcitr02g04770.1.1	441	45	486	TBB3_DROME	447	1	448	0.0	81.737	89	91.54	3	8	761	1966
Dcitr02g04770.1.1	408	64	472	A1ZBL0_DROME	409	29	438	0.0	85.366	82	94.15	1	1	730	1884
Dcitr02g04790.1.1	251	32	283	SINA_DROME	252	62	314	5.05e-149	79.051	89	85.38	1	1	419	1077
Dcitr02g04880.1.1	34	1	35	TRPCG_DROME	34	1139	1173	8.79e-10	77.143	79	97.14	0	0	63.5	153
Dcitr02g04950.1.1	301	56	357	Q7KN94_DROME	301	14	315	5.33e-148	70.627	77	83.83	2	2	421	1083
Dcitr02g04950.1.1	301	56	357	Q7KLW5_DROME	301	24	325	6.08e-148	70.627	77	83.83	2	2	422	1084
Dcitr02g05670.1.1	461	1	462	RBBP5_DROME	485	1	486	0.0	70.782	99	81.89	5	24	707	1826
Dcitr02g06050.1.1	146	1	147	MLC2_DROME	146	1	147	3.19e-85	80.272	99	87.07	0	0	245	626
Dcitr02g06230.1.1	579	1	580	2AAA_DROME	579	1	580	0.0	79.310	99	87.59	0	0	915	2366
Dcitr02g06620.1.1	183	1	184	Q4V5H1_DROME	182	1	183	3.47e-120	86.413	99	93.48	1	1	337	863
Dcitr02g06810.1.1	526	12	538	ERCC3_DROME	540	43	583	0.0	78.125	99	86.03	5	20	860	2221
Dcitr02g06840.1.1	455	26	481	MAD_DROME	454	1	455	0.0	81.917	95	87.58	4	7	763	1971
Dcitr02g07290.1.1	174	1	175	ARF6_DROME	174	1	175	4.09e-127	96.571	99	97.71	0	0	353	906
Dcitr02g07390.1.1	174	1	175	ARF6_DROME	174	1	175	4.09e-127	96.571	99	97.71	0	0	353	906
Dcitr02g07600.1.1	431	1	432	ENO_DROME	431	68	499	0.0	83.796	99	90.51	0	0	730	1885
Dcitr02g08480.1.1	95	1	96	RL9_DROME	96	90	186	4.71e-58	88.660	95	93.81	1	1	176	446
Dcitr02g08480.1.2	184	1	185	RL9_DROME	185	1	186	1.43e-108	80.645	97	88.71	1	1	308	788
Dcitr02g09040.1.1	46	425	471	Q058U9_DROME	46	206	252	4.06e-15	72.340	78	87.23	0	0	77.4	189
Dcitr02g09040.1.1	46	425	471	Q9BML5_DROME	46	206	252	3.44e-15	72.340	78	87.23	0	0	78.2	191
Dcitr02g09680.1.1	127	1	128	RPB9_DROME	128	1	129	4.27e-81	85.271	99	90.70	1	1	233	595
Dcitr02g10190.1.1	52	10	62	Q9VNG6_DROME	52	28	80	2.79e-18	81.132	83	94.34	0	0	74.7	182
Dcitr02g10570.1.1	158	1	159	Q9VTN7_DROME	158	15	173	3.21e-88	73.585	97	86.16	0	0	266	679
Dcitr02g10920.1.1	171	7	178	KINH_DROME	171	3	174	8.02e-102	85.465	86	93.02	0	0	314	804
Dcitr02g10950.1.1	565	748	1313	KINH_DROME	607	79	686	0.0	71.358	92	79.21	7	48	845	2183
Dcitr02g10950.1.1	93	612	705	KINH_DROME	93	796	889	1.37e-45	91.489	92	95.74	0	0	178	452
Dcitr02g10980.1.1	106	1	107	ITBX_DROME	106	295	401	1.15e-50	70.093	94	84.11	0	0	170	430
Dcitr02g11270.1.1	82	23	105	OAF_DROME	82	90	172	2.05e-37	72.289	74	89.16	0	0	130	328
Dcitr02g11320.1.1	456	1	457	DDX6_DROME	458	1	459	0.0	81.075	99	89.46	4	14	774	1999
Dcitr02g11400.1.1	187	1	188	U2AF1_DROME	187	1	188	5.64e-137	94.681	95	97.87	0	0	383	983
Dcitr02g11430.1.1	417	393	810	B7Z126_DROME	419	1070	1489	0.0	85.238	72	90.95	2	2	738	1906
Dcitr02g11430.1.1	17	64	81	B7Z126_DROME	17	366	383	4.4	72.222	72	88.89	0	0	30.4	67
Dcitr02g11430.1.1	417	393	810	M9PIZ6_DROME	419	846	1265	0.0	85.238	72	90.95	2	2	737	1903
Dcitr02g11430.1.1	17	64	81	M9PIZ6_DROME	17	142	159	4.9	72.222	72	88.89	0	0	30.0	66
Dcitr02g11430.1.1	417	393	810	Q8IRT7_DROME	419	835	1254	0.0	85.238	72	90.95	2	2	737	1903
Dcitr02g11430.1.1	17	64	81	Q8IRT7_DROME	17	131	148	4.9	72.222	72	88.89	0	0	30.4	67
Dcitr02g11590.1.1	212	24	236	CNEP1_DROME	215	28	243	6.24e-129	80.556	90	90.74	1	3	363	932
Dcitr02g11790.1.1	259	5	264	ACH3_DROME	258	9	267	2.56e-170	89.313	98	92.37	2	5	480	1235
Dcitr02g11800.1.1	488	5	493	ACH3_DROME	498	9	507	0.0	87.450	99	91.24	4	16	865	2236
Dcitr02g11800.1.1	183	488	671	ACH3_DROME	194	327	521	6.82e-99	78.462	99	84.62	2	11	312	800
Dcitr02g12000.1.1	399	4	403	PRS8_DROME	399	6	405	0.0	95.500	99	97.75	0	0	787	2033
Dcitr02g12060.1.1	399	4	403	PRS8_DROME	399	6	405	0.0	95.250	99	97.50	0	0	785	2027
Dcitr02g12770.1.1	165	1	166	Q86MN7_DROME	165	127	292	4.40e-105	87.349	99	93.37	0	0	314	804
Dcitr02g13120.1.1	420	1	421	O62531_DROME	424	1	425	0.0	90.118	99	96.00	3	4	791	2044
Dcitr02g13180.1.1	420	1	421	O62531_DROME	424	1	425	0.0	90.118	99	96.00	3	4	791	2044
Dcitr02g13260.1.1	561	11	572	X2J8E9_DROME	559	73	632	0.0	74.199	97	85.05	1	2	855	2209
Dcitr02g13260.1.1	561	11	572	DS_DROME	559	20	579	0.0	74.199	97	85.05	1	2	855	2208
Dcitr02g13450.1.1	98	1	99	ER_DROME	98	1	99	4.58e-63	83.838	96	93.94	0	0	186	471
Dcitr02g13500.1.1	98	1	99	ER_DROME	98	1	99	4.58e-63	83.838	96	93.94	0	0	186	471
Dcitr02g13520.1.1	34	568	602	Q9VM47_DROME	34	657	691	1.94e-07	74.286	86	88.57	0	0	53.9	128
Dcitr02g13520.1.1	34	568	602	Q7KXY9_DROME	34	645	679	2.00e-07	74.286	86	88.57	0	0	53.5	127
Dcitr02g13530.1.1	98	1	99	ER_DROME	98	1	99	4.58e-63	83.838	96	93.94	0	0	186	471
Dcitr02g13550.1.1	329	43	372	Q9VKX2_DROME	328	1	329	1.24e-171	73.333	88	83.64	1	1	481	1238
Dcitr02g13550.1.1	329	43	372	Q8MQS7_DROME	328	1	329	1.90e-171	73.333	88	83.64	1	1	481	1237
Dcitr02g13700.1.1	181	1	182	ARF1_DROME	181	1	182	1.62e-131	97.253	99	98.35	0	0	365	937
Dcitr02g13700.1.1	176	1	177	ARF2_DROME	176	1	177	7.62e-108	83.051	97	88.70	0	0	305	781
Dcitr02g13770.1.1	87	1	88	Q9W424_DROME	87	1	88	1.10e-55	90.909	97	95.45	0	0	174	442
Dcitr02g13770.1.1	87	1	88	Q24534_DROME	106	1	107	3.68e-51	74.766	97	78.50	1	19	163	413
Dcitr02g13850.1.1	389	63	452	SY65_DROME	386	79	465	0.0	78.462	85	87.95	3	3	608	1569
Dcitr02g14010.1.1	376	1	377	M9PFD8_DROME	376	118	494	0.0	80.000	99	89.21	3	6	611	1576
Dcitr02g14010.1.1	376	1	377	Q7KTF9_DROME	376	118	494	0.0	80.000	99	89.21	3	6	611	1575
Dcitr02g14010.1.1	376	1	377	Q8T7S2_DROME	376	118	494	0.0	79.474	99	88.95	3	6	607	1566
Dcitr02g14090.1.1	143	1	144	CNI_DROME	143	1	144	6.71e-76	73.611	99	83.33	0	0	221	564
Dcitr02g14110.1.1	143	1	144	CNI_DROME	143	1	144	6.71e-76	73.611	99	83.33	0	0	221	564
Dcitr02g14330.1.1	347	69	416	HNF4_DROME	345	142	487	0.0	72.286	73	83.14	2	6	523	1346
Dcitr02g14570.1.1	138	2	140	MED22_DROME	138	5	143	8.61e-73	73.381	99	87.77	0	0	213	543
Dcitr02g14860.1.1	276	1	277	TUTL_DROME	276	259	535	5.07e-153	77.617	84	89.53	0	0	466	1198
Dcitr02g14860.1.2	276	1	277	TUTL_DROME	276	259	535	5.07e-153	77.617	84	89.53	0	0	466	1198
Dcitr02g14870.1.1	534	1	535	TUTL_DROME	535	371	906	0.0	71.375	95	84.01	3	5	811	2096
Dcitr02g14870.1.2	534	1	535	TUTL_DROME	535	371	906	0.0	71.375	95	84.01	3	5	811	2096
Dcitr02g14880.1.1	150	20	170	TUTL_DROME	150	756	906	1.84e-81	81.457	82	90.73	0	0	262	669
Dcitr02g15270.1.1	964	283	1247	A1Z9L3_DROME	961	271	1232	0.0	84.671	77	92.49	7	17	1700	4402
Dcitr02g15270.1.1	964	283	1247	Q8MSQ6_DROME	961	271	1232	0.0	84.568	77	92.49	7	17	1698	4398
Dcitr02g15270.1.2	964	329	1293	A1Z9L3_DROME	961	271	1232	0.0	84.671	74	92.49	7	17	1701	4406
Dcitr02g15270.1.2	964	329	1293	Q8MSQ6_DROME	961	271	1232	0.0	84.568	74	92.49	7	17	1701	4404
Dcitr02g15410.1.1	361	29	390	Q7KTN8_DROME	361	65	426	0.0	75.967	93	86.46	0	0	570	1468
Dcitr02g15410.1.1	361	29	390	Q9VMR4_DROME	361	65	426	0.0	75.967	93	86.46	0	0	569	1467
Dcitr02g15410.1.1	361	29	390	Q7KIQ2_DROME	361	65	426	0.0	75.967	93	86.46	0	0	569	1467
Dcitr02g15410.1.2	374	43	417	Q7KTN8_DROME	371	55	426	0.0	74.933	90	85.07	1	3	577	1486
Dcitr02g15410.1.2	374	43	417	E0A9E1_DROME	371	55	426	0.0	74.933	90	85.07	1	3	576	1485
Dcitr02g15410.1.2	374	43	417	A8DYV6_DROME	371	55	426	0.0	74.933	90	85.07	1	3	576	1484
Dcitr02g15660.1.1	222	57	279	LIX1_DROME	222	24	246	3.36e-138	81.614	79	89.69	0	0	390	1001
Dcitr02g16180.1.1	730	1	731	Q9VQE0_DROME	734	1	735	0.0	72.244	99	81.81	8	40	1085	2807
Dcitr02g16180.1.1	730	1	731	Q8IHG0_DROME	734	1	735	0.0	72.244	99	81.81	8	40	1085	2806
Dcitr02g16410.1.1	181	31	212	Q9W227_DROME	181	22	203	8.28e-97	72.527	85	86.26	0	0	280	715
Dcitr02g17010.1.1	258	44	302	EWG_DROME	250	98	348	6.90e-118	73.563	80	86.21	3	12	364	934
Dcitr02g17010.1.3	258	44	302	EWG_DROME	250	98	348	6.90e-118	73.563	80	86.21	3	12	364	934
Dcitr02g17010.1.4	258	44	302	EWG_DROME	250	98	348	6.90e-118	73.563	80	86.21	3	12	364	934
Dcitr02g17350.1.1	442	1	443	O62530_DROME	436	1	437	0.0	92.099	99	94.58	1	6	846	2185
Dcitr02g17420.1.1	85	1	86	DRI_DROME	85	320	405	1.08e-45	86.047	75	91.86	0	0	156	394
Dcitr02g17550.1.1	714	1	715	Q9Y119_DROME	704	99	803	0.0	71.548	97	82.43	5	14	1070	2767
Dcitr02g17550.1.2	714	1	715	Q9Y119_DROME	704	99	803	0.0	71.548	97	82.43	5	14	1070	2767
Dcitr02g18000.1.1	328	1	329	CSK2A_DROME	328	1	329	0.0	90.881	93	95.14	0	0	587	1513
Dcitr02g18030.1.1	124	14	138	CSK2A_DROME	124	83	207	2.97e-85	95.200	84	97.60	0	0	252	644
Dcitr02g18070.1.1	104	211	315	A0A0B4K827_DROME	102	136	238	7.13e-47	73.333	93	84.76	1	2	169	427
Dcitr02g18070.1.1	104	211	315	Q0E9M0_DROME	102	136	238	7.85e-47	73.333	93	84.76	1	2	169	427
Dcitr02g18070.1.1	104	211	315	Q0E9J3_DROME	103	136	239	2.14e-46	73.333	93	85.71	1	1	167	424
Dcitr02g18120.1.1	82	1	83	Q7KA43_DROME	82	1	83	7.06e-45	73.494	98	85.54	0	0	138	348
Dcitr02g18150.1.1	82	1	83	Q7KA43_DROME	82	1	83	7.06e-45	73.494	98	85.54	0	0	138	348
Dcitr02g18880.1.1	428	16	444	CSN2_DROME	428	16	444	0.0	84.848	96	91.38	0	0	758	1956
Dcitr02g18900.1.1	428	16	444	CSN2_DROME	428	16	444	0.0	84.848	96	91.38	0	0	758	1956
Dcitr02g19110.1.1	183	1	184	RAS3_DROME	183	1	184	2.25e-113	91.848	99	94.57	0	0	319	818
Dcitr02g19250.1.1	111	1	112	DAD1_DROME	111	1	112	9.75e-59	75.893	99	83.93	0	0	176	445
Dcitr02g19250.1.1	99	13	112	DAD1_ARAVE	99	14	113	9.22e-58	84.000	88	89.00	0	0	173	438
Dcitr02g19330.1.1	111	1	112	DAD1_DROME	111	1	112	9.75e-59	75.893	99	83.93	0	0	176	445
Dcitr02g19330.1.1	99	13	112	DAD1_ARAVE	99	14	113	9.22e-58	84.000	88	89.00	0	0	173	438
Dcitr02g19740.1.1	402	1	403	HSP7D_DROME	397	1	398	0.0	90.571	97	95.04	1	5	756	1952
Dcitr02g19740.1.1	398	5	403	HSP71_DROME	394	2	396	0.0	81.500	96	90.75	2	6	680	1755
Dcitr02g19740.1.1	398	5	403	HSP70_DROME	394	2	396	0.0	81.500	96	90.75	2	6	680	1755
Dcitr02g19930.1.1	430	1	431	AKT1_DROME	429	166	595	0.0	73.333	99	83.68	3	9	664	1713
Dcitr02g20010.1.1	514	21	535	Q9VV60_DROME	517	8	525	0.0	71.073	96	81.80	4	11	748	1932
Dcitr02g20030.1.1	13	255	268	Q8MRQ2_DROME	13	387	400	1.0	78.571	76	85.71	0	0	30.4	67
Dcitr02g20070.1.1	514	21	535	Q9VV60_DROME	517	8	525	0.0	71.073	96	81.99	4	11	749	1933
Dcitr02g20190.1.1	471	1	472	ROP_DROME	481	1	482	0.0	72.050	100	82.40	2	12	722	1864
Dcitr02g20210.1.1	475	2	477	ROP_DROME	474	120	594	0.0	75.630	99	85.92	1	1	768	1982
Dcitr03g01400.1.1	386	23	409	COLL_DROME	397	36	433	0.0	87.407	89	91.11	4	25	729	1881
Dcitr03g01400.1.2	390	23	413	COLL_DROME	397	36	433	0.0	87.407	89	90.86	4	21	725	1872
Dcitr03g01410.1.1	138	2	140	COLL_DROME	138	63	201	1.58e-95	93.525	99	97.12	0	0	285	730
Dcitr03g01660.1.1	28	348	376	A0A0B4KGY9_DROME	28	539	567	7.34e-10	82.759	76	89.66	0	0	60.1	144
Dcitr03g01660.1.1	28	348	376	Q8MS04_DROME	28	606	634	6.64e-10	82.759	76	89.66	0	0	60.1	144
Dcitr03g01660.1.1	28	348	376	Q9VBQ1_DROME	28	578	606	7.28e-10	82.759	76	89.66	0	0	60.1	144
Dcitr03g01690.1.1	443	1	444	TBB3_DROME	451	1	452	0.0	70.354	97	84.29	2	8	666	1718
Dcitr03g01690.1.1	427	1	428	TBB2_DROME	428	1	429	0.0	73.660	94	86.01	1	1	664	1713
Dcitr03g01690.1.1	408	20	428	A1ZBL0_DROME	409	29	438	0.0	73.902	89	87.07	1	1	639	1649
Dcitr03g02350.1.1	183	29	212	ARL2_DROME	183	1	184	3.33e-101	74.457	86	84.78	0	0	290	742
Dcitr03g02530.1.1	183	41	224	ARL2_DROME	183	1	184	4.85e-101	74.457	82	84.78	0	0	290	742
Dcitr03g03150.1.1	302	1	303	Q9VHJ4_DROME	302	1	303	2.18e-176	75.248	99	86.47	0	0	489	1259
Dcitr03g03220.1.1	128	12	140	Q9VHJ4_DROME	128	38	166	1.09e-71	74.419	87	87.60	0	0	217	552
Dcitr03g03430.1.1	449	1234	1683	Q9VHK1_DROME	463	769	1232	0.0	70.323	75	83.44	3	16	665	1715
Dcitr03g03430.1.1	449	1234	1683	Q8MQQ3_DROME	463	405	868	0.0	70.323	75	83.44	3	16	662	1709
Dcitr03g03430.1.1	449	1234	1683	Q94880_DROME	463	405	868	0.0	70.323	75	83.44	3	16	662	1709
Dcitr03g03510.1.1	525	44	569	A0A0B4KHB9_DROME	544	167	711	0.0	70.513	91	82.60	4	21	791	2044
Dcitr03g03510.1.1	495	74	569	Q8IN89_DROME	513	466	979	0.0	72.039	86	83.69	3	20	773	1997
Dcitr03g03660.1.1	218	100	318	PSA2_DROME	219	15	234	6.90e-130	79.091	99	89.55	1	1	369	947
Dcitr03g03660.1.1	105	1	106	PSA2_DROME	111	1	112	7.46e-46	71.429	99	82.14	2	6	154	390
Dcitr03g03750.1.1	300	1	301	Q9VBC7_DROME	299	355	654	1.24e-175	79.070	99	88.04	1	1	500	1287
Dcitr03g03750.1.1	300	1	301	Q9UAE7_DROME	299	355	654	2.14e-175	79.070	99	88.04	1	1	499	1285
Dcitr03g04010.1.1	68	9	77	HTH_DROME	71	416	487	3.26e-21	70.270	88	74.32	5	7	84.7	208
Dcitr03g04390.1.1	145	30	175	RL4_DROME	150	36	186	1.10e-77	75.497	77	84.77	1	5	237	604
Dcitr03g04990.1.1	91	1	92	CPO_DROME	91	441	532	2.84e-63	100.000	91	100.00	0	0	201	510
Dcitr03g04990.1.2	82	1	83	CPO_DROME	81	451	532	8.14e-54	98.795	90	98.80	1	1	175	444
Dcitr03g05550.1.1	111	6	117	SNP25_DROME	111	101	212	7.44e-70	89.286	95	95.54	0	0	207	527
Dcitr03g05560.1.1	18	766	784	Q0KI85_DROME	18	1069	1087	0.097	84.211	97	89.47	0	0	35.8	81
Dcitr03g06150.1.1	332	2	334	SUCA_DROME	326	1	327	3.92e-168	77.177	99	84.38	1	6	470	1209
Dcitr03g06220.1.1	357	2	359	SUCA_DROME	326	1	327	1.10e-161	71.788	99	78.21	2	31	455	1170
Dcitr03g06270.1.1	322	96	418	SUCA_DROME	316	11	327	1.16e-167	78.947	77	87.00	1	6	472	1215
Dcitr03g06350.1.1	157	16	173	Q9VV89_DROME	165	9	174	2.04e-90	75.904	91	89.16	1	8	260	665
Dcitr03g06350.1.1	154	19	173	Q8IQP2_DROME	162	1	163	2.54e-88	75.460	89	88.96	1	8	255	651
Dcitr03g06350.1.1	143	16	159	Q8IQP1_DROME	151	9	160	1.25e-80	75.658	83	88.82	1	8	236	601
Dcitr03g06530.1.1	595	2	597	WDR1_DROME	597	8	605	0.0	72.408	99	84.62	1	2	927	2395
Dcitr03g07070.1.1	119	1	120	Q9VVU2_DROME	119	30	149	2.39e-69	79.167	96	88.33	0	0	204	519
Dcitr03g07170.1.1	148	1	149	Q9VVU2_DROME	148	1	149	1.77e-87	79.195	97	87.92	0	0	251	641
Dcitr03g07180.1.1	106	1	107	Q9VVU2_DROME	106	1	107	3.75e-61	78.505	98	89.72	0	0	182	463
Dcitr03g07360.1.1	226	1	227	PP1B_DROME	226	1	227	5.20e-155	91.189	86	93.39	0	0	434	1115
Dcitr03g07360.1.1	227	6	233	PP12_DROME	227	5	232	3.68e-147	84.649	87	89.91	0	0	413	1061
Dcitr03g07360.1.1	226	6	232	PP11_DROME	226	5	231	1.76e-145	84.141	86	89.43	0	0	409	1052
Dcitr03g07360.1.2	226	1	227	PP1B_DROME	226	1	227	5.20e-155	91.189	86	93.39	0	0	434	1115
Dcitr03g07360.1.2	227	6	233	PP12_DROME	227	5	232	3.68e-147	84.649	87	89.91	0	0	413	1061
Dcitr03g07360.1.2	226	6	232	PP11_DROME	226	5	231	1.76e-145	84.141	86	89.43	0	0	409	1052
Dcitr03g07410.1.1	320	1	321	PP1B_DROME	321	1	322	0.0	90.994	99	95.34	1	1	614	1583
Dcitr03g07410.1.1	318	6	324	PP11_DROME	322	5	327	0.0	83.591	98	89.47	2	4	564	1454
Dcitr03g07410.1.1	297	6	303	PP12_DROME	297	5	302	0.0	87.248	92	93.29	0	0	557	1435
Dcitr03g07470.1.1	219	36	255	OAR_DROME	221	99	320	7.45e-101	70.270	75	86.94	1	2	312	799
Dcitr03g07470.1.1	100	263	363	OAR_DROME	99	500	599	2.06e-47	77.228	75	89.11	1	1	171	432
Dcitr03g07690.1.1	366	162	528	Q8IH57_DROME	382	160	542	0.0	71.354	86	82.55	3	18	552	1423
Dcitr03g07690.1.1	366	162	528	Q8IGS0_DROME	382	160	542	0.0	71.429	86	82.86	4	20	552	1422
Dcitr03g07690.1.1	366	162	528	Q86NW1_DROME	382	160	542	0.0	71.429	86	82.86	4	20	552	1422
Dcitr03g07880.1.1	139	1	140	Q9VGS1_DROME	139	226	365	2.71e-75	73.571	97	87.86	0	0	228	580
Dcitr03g07900.1.1	141	1	142	Q9VDC3_DROME	141	1	142	1.94e-101	98.592	99	99.30	0	0	286	731
Dcitr03g07900.1.1	141	1	142	Q9GQM7_DROME	141	1	142	1.61e-98	95.775	99	97.89	0	0	278	712
Dcitr03g07990.1.1	141	1	142	Q9VDC3_DROME	141	1	142	1.94e-101	98.592	99	99.30	0	0	286	731
Dcitr03g07990.1.1	141	1	142	Q9GQM7_DROME	141	1	142	1.61e-98	95.775	99	97.89	0	0	278	712
Dcitr03g08000.1.1	139	1	140	Q9VGS1_DROME	139	226	365	2.71e-75	73.571	97	87.86	0	0	228	580
Dcitr03g08030.1.1	141	1	142	Q9VDC3_DROME	141	1	142	1.94e-101	98.592	99	99.30	0	0	286	731
Dcitr03g08030.1.1	141	1	142	Q9GQM7_DROME	141	1	142	1.61e-98	95.775	99	97.89	0	0	278	712
Dcitr03g08060.1.1	116	1	117	RS25_DROME	115	1	116	8.46e-45	83.761	97	92.31	1	1	141	355
Dcitr03g08060.1.2	116	1	117	RS25_DROME	115	1	116	8.46e-45	83.761	97	92.31	1	1	141	355
Dcitr03g08060.1.3	116	1	117	RS25_DROME	115	1	116	8.46e-45	83.761	97	92.31	1	1	141	355
Dcitr03g08100.1.1	437	14	451	GLUCL_DROME	446	10	456	0.0	78.982	96	85.84	8	19	717	1850
Dcitr03g08180.1.1	182	1	183	ATNA_DROME	206	835	1041	1.11e-106	74.396	99	79.71	1	24	327	839
Dcitr03g08200.1.1	315	1	316	ATNA_DROME	315	726	1041	0.0	90.190	99	93.99	0	0	607	1564
Dcitr03g08200.1.1	314	2	316	A8QI34_DROME	314	695	1009	1.19e-159	70.476	99	81.27	0	0	471	1211
Dcitr03g08200.1.1	314	2	316	Q9U458_DROME	314	695	1009	7.28e-159	70.159	99	80.95	0	0	469	1206
Dcitr03g08210.1.1	115	1	116	ATNA_DROME	114	601	715	2.39e-66	92.241	98	96.55	1	1	215	547
Dcitr03g08220.1.1	496	3	499	ATNA_DROME	457	6	463	0.0	81.489	99	87.12	2	39	826	2133
Dcitr03g08230.1.1	867	3	870	ATNA_DROME	829	6	835	0.0	85.386	99	91.02	3	40	1514	3919
Dcitr03g08480.1.1	115	1	116	POXM_DROME	113	32	145	2.93e-67	87.931	81	94.83	1	2	210	534
Dcitr03g08560.1.1	115	1	116	POXM_DROME	113	32	145	2.93e-67	87.931	81	94.83	1	2	210	534
Dcitr03g08840.1.1	191	1	192	HSP7E_DROME	191	493	684	8.74e-95	74.479	98	89.06	0	0	289	739
Dcitr03g08850.1.1	439	13	452	HSP7E_DROME	437	33	470	0.0	85.682	96	93.18	1	2	783	2022
Dcitr03g08890.1.1	676	1	677	HSP7E_DROME	683	1	684	0.0	78.229	99	88.53	3	17	1098	2840
Dcitr03g08970.1.1	642	38	680	HSP7E_DROME	641	43	684	0.0	81.988	94	92.08	2	3	1087	2810
Dcitr03g09430.1.1	249	178	427	O96660_DROME	250	236	486	9.07e-155	85.657	99	88.84	1	1	446	1147
Dcitr03g09490.1.1	248	145	393	Q9TZQ2_DROME	249	235	484	5.48e-155	86.000	92	88.80	1	1	445	1145
Dcitr03g09490.1.1	248	145	393	O96660_DROME	249	237	486	8.49e-155	86.000	92	88.80	1	1	445	1144
Dcitr03g09590.1.1	727	1	728	MCM5_DROME	731	1	732	0.0	73.806	99	87.04	4	6	1142	2955
Dcitr03g09600.1.1	315	1	316	MCM5_DROME	319	322	641	1.07e-175	74.688	78	89.06	2	4	507	1306
Dcitr03g10090.1.1	311	450	761	M9PE44_DROME	303	743	1046	9.83e-167	79.553	78	83.39	3	10	508	1307
Dcitr03g10090.1.1	311	450	761	Q9VZH2_DROME	303	744	1047	1.24e-166	79.553	78	83.39	3	10	508	1307
Dcitr03g10140.1.1	292	440	732	Q9VZH2_DROME	303	744	1047	2.27e-160	80.263	77	85.20	5	11	490	1262
Dcitr03g10140.1.1	16	473	489	Q9VZH2_DROME	16	673	689	0.29	82.353	77	88.24	0	0	33.9	76
Dcitr03g10140.1.1	292	440	732	M9PE44_DROME	303	743	1046	2.51e-160	80.263	77	85.20	5	11	490	1261
Dcitr03g10140.1.1	16	473	489	M9PE44_DROME	16	672	688	0.29	82.353	77	88.24	0	0	33.9	76
Dcitr03g10940.1.1	109	2	111	Q9VB23_DROME	110	3	113	2.43e-45	80.180	72	88.29	1	1	154	389
Dcitr03g10950.1.1	441	2	443	Q9VB23_DROME	457	3	460	0.0	77.729	99	86.03	4	16	692	1785
Dcitr03g11060.1.1	114	1	115	IF4A3_DROME	114	285	399	2.19e-77	96.522	99	98.26	0	0	233	593
Dcitr03g11060.1.1	110	5	115	IF4A_DROME	110	293	403	8.80e-47	77.477	96	90.09	0	0	154	389
Dcitr03g11260.1.1	311	101	412	PUF68_DROME	327	41	368	1.87e-147	72.205	77	80.36	3	22	439	1130
Dcitr03g11360.1.1	205	1	206	X2J708_DROME	205	21	226	2.59e-117	75.243	99	88.83	0	0	339	869
Dcitr03g11360.1.1	205	1	206	Q9VMN3_DROME	205	47	252	4.07e-117	75.243	99	88.83	0	0	339	870
Dcitr03g11360.1.1	205	1	206	M9MRD8_DROME	205	44	249	4.86e-117	75.243	99	88.83	0	0	339	869
Dcitr03g11540.1.1	397	314	711	A0A0B4KGU2_DROME	392	228	620	0.0	78.894	78	88.44	1	5	674	1740
Dcitr03g11540.1.1	397	314	711	Q9VEL0_DROME	392	228	620	0.0	78.894	78	88.44	1	5	674	1740
Dcitr03g11630.1.1	204	1	205	Q9VBL2_DROME	203	1	204	3.69e-113	73.786	98	89.32	3	3	321	822
Dcitr03g11900.1.1	877	1	878	Q9VGZ3_DROME	897	1	898	0.0	71.000	99	82.67	8	24	1286	3329
Dcitr03g11900.1.1	877	1	878	Q9NFX2_DROME	897	1	898	0.0	70.889	99	82.67	8	24	1285	3324
Dcitr03g11920.1.1	891	1	892	Q9VGZ3_DROME	897	1	898	0.0	72.000	99	84.00	7	10	1314	3400
Dcitr03g11920.1.1	891	1	892	Q9NFX2_DROME	897	1	898	0.0	71.889	99	84.00	7	10	1313	3397
Dcitr03g11920.1.1	891	1	892	O76935_DROME	897	1	898	0.0	71.000	99	83.11	7	10	1293	3347
Dcitr03g12290.1.1	452	64	516	A0A0B4K7M0_DROME	448	54	502	0.0	70.897	77	82.93	4	12	684	1766
Dcitr03g12290.1.1	452	64	516	Q9W1Y2_DROME	448	54	502	0.0	70.897	77	82.93	4	12	684	1765
Dcitr03g12290.1.1	452	64	516	Q8T0K5_DROME	448	54	502	0.0	70.678	77	82.71	4	12	680	1755
Dcitr03g12300.1.1	452	110	562	A0A0B4K7M0_DROME	448	54	502	0.0	70.897	78	82.93	4	12	682	1759
Dcitr03g12300.1.1	452	110	562	Q9W1Y2_DROME	448	54	502	0.0	70.897	77	82.93	4	12	681	1758
Dcitr03g12300.1.1	452	110	562	Q8T0K5_DROME	448	54	502	0.0	70.678	77	82.71	4	12	678	1750
Dcitr03g12320.1.1	326	64	390	Q9W1Y2_DROME	326	9	335	3.62e-167	70.122	82	80.49	2	2	485	1248
Dcitr03g12320.1.1	326	64	390	Q9W1Y3_DROME	326	9	335	5.78e-167	70.122	82	80.49	2	2	485	1248
Dcitr03g12320.1.1	296	94	390	A0A0B4K7M0_DROME	297	38	335	6.13e-167	75.503	75	84.90	1	1	485	1249
Dcitr03g12330.1.1	452	110	562	A0A0B4K7M0_DROME	448	54	502	0.0	70.897	78	82.93	4	12	682	1759
Dcitr03g12330.1.1	452	110	562	Q9W1Y2_DROME	448	54	502	0.0	70.897	77	82.93	4	12	681	1758
Dcitr03g12330.1.1	452	110	562	Q8T0K5_DROME	448	54	502	0.0	70.678	77	82.71	4	12	678	1750
Dcitr03g12510.1.1	596	1	597	INT11_DROME	595	1	596	0.0	72.000	98	87.00	3	7	942	2436
Dcitr03g12530.1.1	596	1	597	INT11_DROME	595	1	596	0.0	72.000	98	87.00	3	7	943	2437
Dcitr03g12690.1.1	279	44	323	ERF1_DROME	280	131	411	0.0	94.662	85	97.15	1	1	551	1420
Dcitr03g12700.1.1	116	1	117	ERF1_DROME	113	1	114	1.98e-74	96.581	99	97.44	1	3	226	577
Dcitr03g12710.1.1	65	17	82	DENR_DROME	65	123	188	3.40e-37	90.909	78	95.45	0	0	122	306
Dcitr03g12720.1.1	354	1	355	ERF1_DROME	352	1	353	0.0	95.225	87	96.91	2	4	694	1790
Dcitr03g12740.1.1	439	1	440	ERF1_DROME	437	1	438	0.0	94.331	99	96.83	2	4	853	2205
Dcitr03g12980.1.1	465	2	467	A0A0B4KHK1_DROME	502	4	506	0.0	74.257	92	82.38	3	41	770	1989
Dcitr03g12980.1.1	465	2	467	Q9VDE3_DROME	502	4	506	0.0	74.257	92	82.38	3	41	769	1987
Dcitr03g12980.1.1	465	2	467	O44382_DROME	502	4	506	0.0	73.861	92	82.18	3	41	767	1981
Dcitr03g13230.1.1	541	753	1294	Q7KSN8_DROME	546	859	1405	0.0	71.481	96	83.55	2	5	811	2094
Dcitr03g13230.1.1	541	753	1294	Q9VGG9_DROME	543	859	1402	0.0	71.298	96	83.55	3	8	807	2084
Dcitr03g13620.1.1	649	134	783	Q9VAQ0_DROME	648	204	852	0.0	71.908	96	85.95	6	11	962	2488
Dcitr03g13620.1.1	636	147	783	Q8SYJ7_DROME	635	1	636	0.0	72.430	81	86.45	6	11	959	2479
Dcitr03g14160.1.1	309	4	313	C1TC_DROME	309	231	540	1.84e-146	71.935	98	80.97	0	0	436	1120
Dcitr03g14440.1.1	37	239	276	SERR_DROME	37	302	339	6.27e-14	71.053	73	84.21	0	0	72.4	176
Dcitr03g14500.1.1	245	19	264	PP13_DROME	245	55	300	1.51e-153	79.675	84	89.84	0	0	430	1106
Dcitr03g14500.1.1	245	19	264	PP12_DROME	245	55	300	1.31e-152	79.675	84	89.43	0	0	428	1100
Dcitr03g14500.1.1	245	19	264	PP11_DROME	245	55	300	1.96e-152	80.081	84	89.43	0	0	428	1101
Dcitr03g14540.1.1	203	1	204	O18332_DROME	201	4	205	1.42e-118	79.024	99	87.32	2	4	334	857
Dcitr03g14630.1.1	203	1	204	O18332_DROME	201	4	205	2.37e-117	78.537	99	86.83	2	4	331	849
Dcitr03g15060.1.1	375	5	380	SGG_DROME	375	4	379	0.0	77.513	89	87.30	3	4	605	1560
Dcitr03g15090.1.1	197	5	202	SGG_DROME	196	4	200	9.27e-98	72.362	83	83.92	2	3	293	751
Dcitr03g16190.1.1	105	1	106	SMD3_DROME	106	1	107	1.04e-54	71.963	88	84.11	1	1	167	423
Dcitr03g16210.1.1	757	23	780	Q9VIE8_DROME	759	27	786	0.0	77.135	97	86.86	4	4	1192	3084
Dcitr03g16210.1.1	758	23	781	Q8T4D6_DROME	760	17	777	0.0	73.753	97	84.38	3	4	1143	2957
Dcitr03g16480.1.1	242	1	243	Q0KHZ6_DROME	242	1	243	1.75e-129	77.778	99	88.48	0	0	376	966
Dcitr03g16480.1.1	236	287	523	Q0KHZ6_DROME	236	17	253	8.65e-125	77.215	99	87.76	0	0	364	935
Dcitr03g16480.1.1	43	244	287	Q0KHZ6_DROME	43	71	114	4.71e-14	72.727	99	84.09	0	0	71.6	174
Dcitr03g16480.1.1	242	1	243	Q8MR58_DROME	242	2	244	2.16e-129	77.778	99	88.48	0	0	376	966
Dcitr03g16480.1.1	236	287	523	Q8MR58_DROME	236	18	254	1.09e-124	77.215	99	87.76	0	0	364	935
Dcitr03g16480.1.1	43	244	287	Q8MR58_DROME	43	72	115	4.92e-14	72.727	99	84.09	0	0	71.6	174
Dcitr03g16510.1.1	217	3	220	Q9W3Q0_DROME	216	2	218	2.78e-124	74.771	99	88.07	1	1	350	897
Dcitr03g16510.1.1	217	3	220	Q8SYS5_DROME	216	2	218	4.40e-123	74.312	99	87.61	1	1	347	890
Dcitr03g16550.1.1	550	453	1003	M9MS55_DROME	558	222	780	0.0	74.778	71	84.72	4	16	856	2212
Dcitr03g16550.1.1	550	453	1003	X2JFA0_DROME	558	219	777	0.0	74.778	71	84.72	4	16	855	2210
Dcitr03g16560.1.1	411	1	412	X2JEY5_DROME	454	288	742	0.0	75.877	97	82.02	2	45	684	1766
Dcitr03g16560.1.1	411	1	412	M9MS55_DROME	454	279	733	0.0	75.877	97	82.02	2	45	684	1766
Dcitr03g16560.1.1	411	1	412	X2JFA0_DROME	454	276	730	0.0	75.877	97	82.02	2	45	684	1765
Dcitr03g16790.1.1	104	1	105	Q9VNF9_DROME	104	85	189	1.89e-51	73.333	99	88.57	0	0	159	403
Dcitr03g16790.1.1	104	1	105	Q7K107_DROME	104	129	233	2.23e-51	73.333	99	88.57	0	0	160	406
Dcitr03g16800.1.1	188	1	189	Q7K107_DROME	188	45	233	5.58e-107	78.307	99	88.36	0	0	305	782
Dcitr03g16800.1.1	188	1	189	Q9VNF9_DROME	188	1	189	6.05e-107	78.307	99	88.36	0	0	303	777
Dcitr03g16900.1.1	248	393	641	Q9VGQ1_DROME	248	220	468	1.61e-138	77.510	90	89.56	0	0	412	1058
Dcitr03g16900.1.1	150	119	269	Q9VGQ1_DROME	150	220	370	1.24e-72	76.159	90	88.08	0	0	241	614
Dcitr03g16910.1.1	439	1	440	PRS4_DROME	438	1	439	0.0	96.154	99	97.96	2	5	838	2164
Dcitr03g16910.1.2	439	1	440	PRS4_DROME	438	1	439	0.0	96.154	99	97.96	2	5	838	2164
Dcitr03g16910.1.3	439	1	440	PRS4_DROME	438	1	439	0.0	96.154	99	97.96	2	5	838	2164
Dcitr03g16910.1.4	439	1	440	PRS4_DROME	438	1	439	0.0	96.154	99	97.96	2	5	838	2164
Dcitr03g17160.1.1	354	48	402	Q9NHN2_DROME	354	111	465	0.0	75.211	87	85.63	0	0	565	1456
Dcitr03g17160.1.1	354	48	402	Q9VPG5_DROME	354	16	370	0.0	74.930	87	85.63	0	0	564	1454
Dcitr03g17160.1.1	359	43	402	Q9VPG4_DROME	364	8	372	0.0	73.699	88	84.38	1	5	563	1452
Dcitr03g17160.1.2	354	48	402	Q9NHN2_DROME	354	111	465	0.0	75.211	87	85.63	0	0	565	1456
Dcitr03g17160.1.2	354	48	402	Q9VPG5_DROME	354	16	370	0.0	74.930	87	85.63	0	0	564	1454
Dcitr03g17160.1.2	359	43	402	Q9VPG4_DROME	364	8	372	0.0	73.699	88	84.38	1	5	563	1452
Dcitr03g17450.1.1	517	1	518	CTNA_DROME	519	396	915	0.0	77.927	98	84.84	2	4	812	2098
Dcitr03g17560.1.1	345	6	351	CTNA_DROME	344	13	357	0.0	82.133	99	91.07	2	3	549	1415
Dcitr03g17680.1.1	759	1	760	UBIQP_DROME	759	1	760	0.0	100.000	99	100.00	0	0	1497	3875
Dcitr03g17680.1.1	685	1	686	UBIQP_DROME	685	77	762	0.0	99.854	99	100.00	0	0	1350	3494
Dcitr03g17680.1.1	531	1	532	Q9W418_DROME	531	1	532	0.0	100.000	99	100.00	0	0	1050	2715
Dcitr03g17680.1.1	531	77	608	Q9W418_DROME	531	1	532	0.0	100.000	99	100.00	0	0	1050	2715
Dcitr03g17680.1.1	531	153	684	Q9W418_DROME	531	1	532	0.0	100.000	99	100.00	0	0	1050	2715
Dcitr03g17680.1.1	531	229	760	Q9W418_DROME	531	1	532	0.0	100.000	99	100.00	0	0	1050	2715
Dcitr03g17680.1.1	303	1	304	Q8MT02_DROME	303	1	304	0.0	100.000	99	100.00	0	0	602	1551
Dcitr03g17680.1.1	303	77	380	Q8MT02_DROME	303	1	304	0.0	100.000	99	100.00	0	0	602	1551
Dcitr03g17680.1.1	303	153	456	Q8MT02_DROME	303	1	304	0.0	100.000	99	100.00	0	0	602	1551
Dcitr03g17680.1.1	303	229	532	Q8MT02_DROME	303	1	304	0.0	100.000	99	100.00	0	0	602	1551
Dcitr03g17680.1.1	303	305	608	Q8MT02_DROME	303	1	304	0.0	100.000	99	100.00	0	0	602	1551
Dcitr03g17680.1.1	303	381	684	Q8MT02_DROME	303	1	304	0.0	100.000	99	100.00	0	0	602	1551
Dcitr03g17680.1.1	303	457	760	Q8MT02_DROME	303	1	304	0.0	100.000	99	100.00	0	0	602	1551
Dcitr03g17850.1.1	252	2	254	Q9VAN7_DROME	252	3	255	1.01e-144	79.051	99	86.17	0	0	404	1039
Dcitr03g17850.1.1	217	37	254	Q9GU73_DROME	217	3	220	1.43e-120	78.440	85	86.70	0	0	342	877
Dcitr03g17870.1.1	252	2	254	Q9VAN7_DROME	252	3	255	1.01e-144	79.051	99	86.17	0	0	404	1039
Dcitr03g17870.1.1	217	37	254	Q9GU73_DROME	217	3	220	1.43e-120	78.440	85	86.70	0	0	342	877
Dcitr03g17990.1.1	252	2	254	Q9VAN7_DROME	252	3	255	1.01e-144	79.051	99	86.17	0	0	404	1039
Dcitr03g17990.1.1	217	37	254	Q9GU73_DROME	217	3	220	1.43e-120	78.440	85	86.70	0	0	342	877
Dcitr03g18620.1.1	243	27	270	ATLAS_DROME	242	5	247	8.55e-134	73.361	86	85.66	1	1	389	998
Dcitr03g18900.1.1	115	6	121	Q9VHC2_DROME	111	1011	1122	3.91e-55	75.000	79	83.62	2	4	185	469
Dcitr03g18900.1.1	115	6	121	Q8SX72_DROME	111	706	817	7.17e-55	75.000	79	83.62	2	4	183	465
Dcitr03g19170.1.1	142	1	143	RS23_DROME	142	1	143	1.65e-99	97.203	99	98.60	0	0	281	719
Dcitr03g19190.1.1	128	1	129	RS23_DROME	142	1	143	1.56e-83	86.713	99	88.81	1	14	244	622
Dcitr03g19190.1.1	87	130	217	RS23_DROME	87	56	143	5.62e-56	98.864	99	98.86	0	0	174	441
Dcitr03g19440.1.1	126	9	135	Q9W2K2_DROME	126	10	136	4.32e-55	70.866	93	88.98	0	0	168	426
Dcitr03g19670.1.1	332	21	353	Q9VGW7_DROME	332	44	376	0.0	71.772	94	90.99	0	0	556	1434
Dcitr03g20270.1.1	159	3	162	Q9U010_DROME	159	35	194	8.90e-108	93.125	82	96.88	0	0	322	826
Dcitr03g20270.1.1	159	3	162	O62609_DROME	159	35	194	1.11e-106	93.125	82	96.88	0	0	322	825
Dcitr03g20270.1.1	159	3	162	O76259_DROME	159	35	194	1.15e-106	93.125	82	96.88	0	0	322	825
Dcitr03g20760.1.1	207	1	208	O18338_DROME	206	1	207	1.66e-131	85.577	99	93.27	1	1	367	942
Dcitr03g20760.1.1	166	42	208	M9NEE8_DROME	165	7	172	1.24e-99	83.234	80	91.62	1	1	285	730
Dcitr03g20770.1.1	375	1	376	ACTZ_DROME	375	1	376	0.0	82.447	99	92.82	0	0	671	1731
Dcitr03g20780.1.1	208	1	209	O18338_DROME	206	1	207	5.65e-124	81.818	99	90.43	2	2	348	893
Dcitr03g20780.1.1	167	42	209	M9NEE8_DROME	165	7	172	4.19e-92	78.571	80	88.10	2	2	266	680
Dcitr03g20790.1.1	215	1	216	ACTZ_DROME	215	141	356	2.80e-130	81.481	96	92.13	0	0	371	953
Dcitr03g20800.1.1	328	1	329	ACTZ_DROME	328	48	376	0.0	81.763	99	92.40	0	0	580	1494
Dcitr03g21060.1.1	463	10	473	DYHC_DROME	463	1098	1561	0.0	75.647	98	87.28	0	0	740	1910
Dcitr03g21070.1.1	1106	2	1108	DYHC_DROME	1118	1578	2696	0.0	79.717	99	88.22	7	32	1877	4863
Dcitr03g21120.1.1	1262	2	1264	DYHC_DROME	1258	3381	4639	0.0	74.211	99	86.28	7	14	1960	5077
Dcitr04g01070.1.1	407	120	527	A1ZBL0_DROME	409	29	438	0.0	86.131	92	91.97	2	4	715	1845
Dcitr04g01070.1.1	99	20	119	A1ZBL0_DROME	99	29	128	4.14e-61	95.000	92	98.00	0	0	207	528
Dcitr04g01070.1.1	407	120	527	TBB2_DROME	409	20	429	0.0	84.672	96	91.73	2	4	708	1828
Dcitr04g01070.1.1	118	1	119	TBB2_DROME	118	1	119	4.68e-71	89.076	96	94.96	0	0	234	596
Dcitr04g01070.1.1	407	120	527	TBB3_DROME	415	20	435	0.0	80.336	96	88.97	3	10	678	1749
Dcitr04g01070.1.1	118	1	119	TBB3_DROME	124	1	125	5.18e-65	81.600	96	89.60	1	6	218	555
Dcitr04g01380.1.1	312	17	329	CAD96_DROME	312	461	773	5.64e-176	74.441	95	86.90	0	0	506	1303
Dcitr04g01980.1.1	339	1	340	ARP2_DROME	344	1	345	0.0	88.116	82	93.62	1	5	639	1647
Dcitr04g02180.1.1	67	9	76	A8JPQ1_DROME	67	112	179	2.01e-29	70.588	86	85.29	0	0	108	269
Dcitr04g02180.1.1	67	9	76	A0A0B4LI09_DROME	67	112	179	2.09e-29	70.588	86	85.29	0	0	108	269
Dcitr04g02430.1.1	529	85	614	TOP1_DROME	536	436	972	0.0	70.147	86	81.14	2	25	796	2055
Dcitr04g02510.1.1	363	1	364	ALF_DROME	360	1	361	0.0	71.154	99	82.14	2	3	515	1326
Dcitr04g02880.1.1	369	488	857	BAP60_DROME	385	130	515	0.0	84.238	75	89.66	3	18	671	1730
Dcitr04g02880.1.1	272	110	382	BAP60_DROME	288	130	418	3.81e-171	85.862	75	90.00	3	18	504	1299
Dcitr04g03150.1.1	484	13	497	ELP3_DROME	537	11	548	0.0	80.297	96	85.87	1	53	864	2232
Dcitr04g03170.1.1	521	13	534	ELP3_DROME	537	11	548	0.0	78.349	96	85.32	4	30	870	2248
Dcitr04g03210.1.1	94	1	95	Q7JZN0_DROME	99	1	100	2.78e-39	72.816	97	81.55	3	11	125	314
Dcitr04g03510.1.1	119	365	484	Q9V9R3_DROME	119	264	383	3.15e-62	85.833	84	93.33	0	0	219	557
Dcitr04g03510.1.1	119	365	484	O96306_DROME	119	264	383	3.15e-62	85.833	84	93.33	0	0	219	557
Dcitr04g03530.1.1	437	5	442	Q8IQU1_DROME	437	55	492	0.0	87.443	90	94.98	0	0	832	2150
Dcitr04g03530.1.1	437	5	442	Q06RG9_DROME	437	55	492	0.0	86.788	90	94.31	2	2	819	2116
Dcitr04g03530.1.1	437	5	442	Q9VW31_DROME	443	55	498	0.0	83.784	90	91.67	1	6	804	2077
Dcitr04g03540.1.1	463	45	508	Q8IQU1_DROME	463	29	492	0.0	85.776	85	93.97	0	0	867	2240
Dcitr04g03540.1.1	463	45	508	Q06RG9_DROME	463	29	492	0.0	85.161	85	93.33	2	2	853	2205
Dcitr04g03540.1.1	463	45	508	E1JI40_DROME	469	53	522	0.0	82.340	85	90.85	1	6	838	2164
Dcitr04g03540.1.2	469	45	514	Q9VW31_DROME	469	29	498	0.0	84.468	85	92.98	0	0	865	2235
Dcitr04g03540.1.2	469	45	514	E1JI40_DROME	469	53	522	0.0	84.468	85	92.98	0	0	864	2233
Dcitr04g03540.1.2	469	45	514	Q8IQU1_DROME	463	29	492	0.0	82.766	85	91.49	1	6	845	2182
Dcitr04g03560.1.1	88	1	89	Q8MSU2_DROME	88	168	256	2.35e-59	93.258	96	95.51	0	0	181	459
Dcitr04g03560.1.1	88	1	89	Q06RG9_DROME	88	437	525	2.67e-56	93.258	96	95.51	0	0	180	457
Dcitr04g03560.1.1	88	1	89	Q8IQU1_DROME	88	437	525	2.67e-56	93.258	96	95.51	0	0	180	457
Dcitr04g03570.1.1	340	1	341	Q86P23_DROME	339	202	541	0.0	90.323	99	94.72	1	1	661	1706
Dcitr04g03570.1.1	340	1	341	Q9VW34_DROME	339	202	541	0.0	90.323	99	94.72	1	1	661	1706
Dcitr04g03590.1.1	543	1	544	Q86P23_DROME	540	1	541	0.0	85.818	99	90.18	5	15	982	2539
Dcitr04g03590.1.1	543	1	544	Q9VW34_DROME	540	1	541	0.0	85.818	99	90.18	5	15	982	2538
Dcitr04g03590.1.2	535	1	536	Q86P23_DROME	540	1	541	0.0	87.085	99	91.51	4	7	989	2558
Dcitr04g03590.1.2	535	1	536	Q9VW34_DROME	540	1	541	0.0	87.085	99	91.51	4	7	989	2558
Dcitr04g03690.1.1	305	1	306	PSMD7_DROME	307	1	308	7.94e-176	78.896	97	89.94	1	2	489	1259
Dcitr04g03710.1.1	281	240	521	MTA70_DROME	286	312	598	3.71e-180	80.139	99	89.20	1	5	519	1337
Dcitr04g03750.1.1	125	1	126	PROF_DROME	125	1	126	1.27e-75	77.778	99	92.86	0	0	219	558
Dcitr04g03760.1.1	393	27	420	IF4A_DROME	393	10	403	0.0	77.411	94	87.06	0	0	601	1549
Dcitr04g03760.1.1	381	39	420	IF4A3_DROME	382	17	399	0.0	70.235	91	84.60	1	1	568	1463
Dcitr04g04200.1.1	206	68	274	Q9VQ29_DROME	206	24	230	7.41e-102	71.635	75	83.65	2	2	296	757
Dcitr04g04890.1.1	389	17	406	SPS1_DROME	387	11	398	0.0	85.897	94	93.85	2	2	709	1830
Dcitr04g05030.1.1	170	1	171	TCTP_DROME	170	1	171	3.59e-98	78.363	99	89.47	0	0	280	716
Dcitr04g05150.1.1	354	79	433	E1JGM9_DROME	349	247	596	0.0	89.577	80	93.80	2	5	650	1677
Dcitr04g05150.1.1	354	79	433	Q963E6_DROME	349	247	596	0.0	89.577	80	93.80	2	5	650	1677
Dcitr04g05150.1.1	354	79	433	Q6NPA6_DROME	349	247	596	0.0	89.577	80	93.80	2	5	650	1676
Dcitr04g05200.1.1	105	16	121	A1ZBL5_DROME	105	846	951	7.64e-57	81.132	87	89.62	0	0	188	477
Dcitr04g05200.1.1	105	16	121	Q9V8V8_DROME	105	833	938	9.95e-57	81.132	87	89.62	0	0	187	476
Dcitr04g05200.1.1	105	16	121	A1ZBL9_DROME	105	833	938	1.45e-56	81.132	87	89.62	0	0	187	476
Dcitr04g05480.1.1	70	2	72	Q9W327_DROME	73	508	581	2.33e-39	83.784	96	91.89	1	3	135	340
Dcitr04g05480.1.1	70	2	72	Q8SXM8_DROME	73	475	548	2.75e-39	83.784	96	91.89	1	3	135	339
Dcitr04g05490.1.1	510	60	570	Q8SXM8_DROME	511	37	548	0.0	73.684	87	85.77	3	3	817	2110
Dcitr04g05490.1.1	510	60	570	Q9W327_DROME	511	70	581	0.0	73.684	87	85.77	3	3	815	2105
Dcitr04g05700.1.1	248	71	319	DX39B_DROME	246	1	247	9.67e-140	82.000	71	87.60	2	4	402	1034
Dcitr04g05710.1.1	181	8	189	DX39B_DROME	181	243	424	6.32e-122	91.758	96	95.60	0	0	350	898
Dcitr04g06050.1.1	120	179	299	Q9V3Y5_DROME	120	876	996	7.96e-55	72.727	76	85.12	0	0	191	484
Dcitr04g06060.1.1	120	761	881	Q9V3Y5_DROME	120	876	996	7.68e-50	72.727	83	85.12	0	0	190	482
Dcitr04g06190.1.1	753	1	754	Q7KVP9_DROME	754	1	755	0.0	72.980	99	85.70	1	1	1177	3046
Dcitr04g06190.1.1	729	25	754	Q9XYZ2_DROME	730	1	731	0.0	72.777	96	85.64	1	1	1136	2938
Dcitr04g06190.1.1	668	86	754	Q6TY68_DROME	669	2	671	0.0	72.239	88	85.37	1	1	1035	2677
Dcitr04g06500.1.1	336	1	337	MO25_DROME	335	1	336	0.0	86.176	98	92.06	3	7	542	1396
Dcitr04g06960.1.1	349	42	391	Q9VPU1_DROME	396	150	546	0.0	70.781	89	78.84	3	47	572	1475
Dcitr04g06960.1.1	349	42	391	Q24218_DROME	396	12	408	0.0	70.781	89	78.84	3	47	572	1473
Dcitr04g06960.1.1	349	42	391	Q8IPW2_DROME	396	12	408	0.0	70.781	89	78.84	3	47	570	1469
Dcitr04g07100.1.1	447	7	454	O76522_DROME	447	6	453	0.0	77.679	97	86.38	0	0	696	1797
Dcitr04g07100.1.1	447	7	454	Q9V455_DROME	447	6	453	0.0	77.679	97	86.38	0	0	696	1796
Dcitr04g07100.1.1	447	7	454	Q9UB78_DROME	447	6	453	0.0	77.455	97	86.16	0	0	693	1789
Dcitr04g07330.1.1	281	1	282	KDC2_DROME	281	302	583	7.09e-165	75.532	99	87.59	0	0	469	1207
Dcitr04g07330.1.2	281	1	282	KDC2_DROME	281	302	583	7.09e-165	75.532	99	87.59	0	0	469	1207
Dcitr04g07330.1.3	281	1	282	KDC2_DROME	281	302	583	7.09e-165	75.532	99	87.59	0	0	469	1207
Dcitr04g07330.1.4	304	9	313	KDC2_DROME	302	281	583	1.39e-175	74.426	97	86.56	1	2	498	1281
Dcitr04g07360.1.1	124	1	125	Q9W499_DROME	122	1	123	1.87e-57	75.200	99	84.00	1	2	173	439
Dcitr04g07360.1.1	124	1	125	Q8MT59_DROME	122	1	123	4.79e-57	74.400	99	84.00	1	2	172	436
Dcitr04g07390.1.1	316	37	353	KDC2_DROME	316	267	583	0.0	74.132	90	86.44	0	0	520	1339
Dcitr04g07620.1.1	224	1	225	KLHDB_DROME	224	389	613	9.04e-154	90.667	96	96.00	0	0	440	1132
Dcitr04g08150.1.1	180	1	181	SEPT1_DROME	184	166	350	2.46e-96	74.595	92	84.32	1	4	283	724
Dcitr04g08200.1.1	199	1	200	UFD1_DROME	200	1	201	9.37e-109	75.248	79	85.15	3	3	316	809
Dcitr04g08250.1.1	93	21	114	MBL_DROME	90	62	152	4.70e-43	71.277	80	86.17	2	3	142	357
Dcitr04g08760.1.1	272	1	273	L2CC_DROME	272	1	273	5.26e-166	80.586	99	92.31	0	0	460	1183
Dcitr04g08780.1.1	263	1	264	L2CC_DROME	263	1	264	1.39e-162	82.197	96	93.18	0	0	451	1161
Dcitr04g08810.1.1	800	2	802	CADN_DROME	800	533	1333	0.0	88.639	100	94.88	0	0	1470	3806
Dcitr04g08850.1.1	932	1	933	CADN_DROME	931	1717	2648	0.0	78.694	97	88.65	3	3	1590	4117
Dcitr04g09430.1.1	212	3	215	O18336_DROME	213	2	215	1.66e-123	75.701	99	88.79	1	1	347	891
Dcitr04g09430.1.1	212	3	215	Q86BK8_DROME	213	26	239	4.87e-123	75.701	99	88.79	1	1	347	891
Dcitr04g09430.1.1	212	3	215	Q8T046_DROME	213	2	215	1.07e-122	75.234	99	88.79	1	1	345	886
Dcitr04g09500.1.1	256	1	257	CCNC_DROME	257	1	258	9.17e-159	81.008	96	91.09	1	1	441	1134
Dcitr04g09520.1.1	143	19	162	DKC1_DROME	143	24	167	4.95e-77	73.611	86	87.50	0	0	237	605
Dcitr04g09770.1.1	722	7	729	EFGM_DROME	724	8	732	0.0	72.138	98	86.48	1	2	1125	2909
Dcitr04g10750.1.1	70	64	134	M9PF56_DROME	72	918	990	1.20e-29	73.973	79	86.30	1	2	111	278
Dcitr04g10750.1.1	70	64	134	Q9VU98_DROME	72	918	990	1.42e-29	73.973	79	86.30	1	2	111	278
Dcitr04g10750.1.1	70	64	134	M9PFJ0_DROME	72	943	1015	1.48e-29	73.973	79	86.30	1	2	111	277
Dcitr04g11260.1.1	658	9	667	EFGM_DROME	693	27	720	0.0	70.749	98	83.57	2	35	1043	2696
Dcitr04g11530.1.1	471	6	477	DDC_DROME	470	40	510	0.0	73.941	98	86.02	1	1	739	1909
Dcitr04g11580.1.1	2156	1	2157	MYO7A_DROME	2162	1	2163	0.0	83.141	99	91.22	5	10	3756	9741
Dcitr04g11590.1.1	436	26	462	SUH_DROME	436	101	537	0.0	87.671	92	96.12	2	2	821	2121
Dcitr04g11590.1.2	436	26	462	SUH_DROME	436	101	537	0.0	87.671	92	96.12	2	2	821	2121
Dcitr04g11660.1.1	273	7	280	WNTG_DROME	266	9	275	2.19e-151	77.372	96	86.50	3	7	436	1120
Dcitr04g11660.1.1	104	291	395	WNTG_DROME	104	364	468	7.98e-54	78.095	96	84.76	0	0	184	468
Dcitr04g11730.1.1	390	2	392	Q7KTE8_DROME	403	25	428	0.0	74.201	74	83.78	6	19	602	1553
Dcitr04g11730.1.1	390	2	392	M9PD84_DROME	403	25	428	0.0	74.201	74	83.78	6	19	601	1549
Dcitr04g11730.1.1	390	2	392	M9ND67_DROME	392	25	417	0.0	75.377	74	84.42	6	12	597	1540
Dcitr04g12380.1.1	107	3	110	ENA_DROME	107	298	405	8.24e-55	75.926	75	88.89	0	0	184	466
Dcitr04g12400.1.1	426	3	429	Q9VSK2_DROME	428	1	429	0.0	80.886	95	89.51	2	2	743	1918
Dcitr04g12400.1.1	426	3	429	O46034_DROME	428	1	429	0.0	80.886	95	89.51	2	2	732	1889
Dcitr04g12400.1.1	426	3	429	P91683_DROME	428	1	429	0.0	80.420	95	89.51	2	2	729	1881
Dcitr04g12570.1.1	83	1	84	NEDD8_DROME	83	1	84	2.54e-50	88.095	87	95.24	0	0	152	385
Dcitr04g12760.1.1	205	14	219	Q9V3I2_DROME	205	14	219	1.87e-107	71.498	94	82.13	2	2	307	787
Dcitr04g12870.1.1	90	9	99	Q9VMR2_DROME	94	214	308	1.38e-46	75.789	74	87.37	1	4	157	397
Dcitr04g12870.1.1	90	9	99	Q8SYY8_DROME	94	214	308	1.89e-46	75.789	74	87.37	1	4	156	395
Dcitr04g12870.1.1	90	9	99	H15_DROME	94	305	399	3.97e-44	72.632	74	86.32	1	4	151	381
Dcitr04g12950.1.1	243	16	259	FBSP1_DROME	243	12	255	3.75e-140	73.361	94	86.89	0	0	393	1010
Dcitr04g12960.1.1	243	16	259	FBSP1_DROME	243	12	255	3.75e-140	73.361	94	86.89	0	0	393	1010
Dcitr04g13310.1.1	741	46	787	Q7K569_DROME	683	41	724	0.0	72.021	94	81.39	7	68	1077	2786
Dcitr04g13330.1.1	152	1	153	RS18_DROME	151	1	152	2.24e-95	83.660	99	94.77	1	1	271	694
Dcitr04g13560.1.1	316	1	317	TF2B_DROME	314	1	315	0.0	86.120	99	92.43	1	2	570	1470
Dcitr04g13690.1.1	63	1	64	Q9VAB9_DROME	62	1	63	1.50e-29	78.125	98	89.06	1	1	98.6	244
Dcitr04g14190.1.1	191	34	225	Q9VJ02_DROME	194	33	227	1.05e-114	81.122	72	87.76	2	5	336	861
Dcitr04g14190.1.1	191	34	225	O96686_DROME	194	33	227	1.05e-114	81.122	72	87.76	2	5	336	861
Dcitr04g15090.1.1	180	6	186	Q9VXK7_DROME	177	44	221	1.15e-112	83.425	97	90.61	2	3	319	818
Dcitr04g15090.1.1	152	34	186	Q9VAK5_DROME	152	60	212	1.08e-104	90.850	82	96.08	0	0	298	764
Dcitr04g15100.1.1	173	26	199	Q9VXK7_DROME	174	47	221	4.62e-107	82.584	87	88.76	3	7	305	782
Dcitr04g15100.1.1	148	51	199	Q9VAK5_DROME	152	60	212	9.43e-100	88.889	75	93.46	1	4	286	733
Dcitr04g15110.1.1	276	7	283	Q9V428_DROME	277	4	281	4.95e-135	71.583	98	85.25	1	1	382	982
Dcitr04g15110.1.1	268	15	283	Q7JVW9_DROME	269	1	270	2.87e-129	71.481	95	85.56	1	1	367	943
Dcitr04g15400.1.1	108	16	124	H2A_DROME	108	16	124	3.59e-74	98.165	87	100.00	0	0	215	548
Dcitr04g15400.1.1	106	17	123	H2A_LITVA	106	17	123	1.74e-73	99.065	86	100.00	0	0	214	544
Dcitr04g15530.1.1	295	1	296	SUDX_DROME	295	654	949	0.0	89.189	99	95.61	0	0	575	1481
Dcitr04g15530.1.1	295	1	296	K7WBL1_9CRUS	295	561	856	0.0	83.108	99	94.26	0	0	544	1401
Dcitr04g15960.1.1	134	13	147	Q9VCT4_DROME	134	101	235	3.30e-72	74.815	89	87.41	0	0	225	573
Dcitr04g15960.1.1	115	32	147	P91670_DROME	115	117	232	6.74e-61	75.862	76	87.93	0	0	195	496
Dcitr04g16160.1.1	287	13	300	CDK1_DROME	286	1	287	7.04e-158	70.486	92	86.11	1	1	442	1136
Dcitr04g16280.1.1	494	180	674	Q9VJ74_DROME	532	283	815	0.0	78.424	82	86.30	1	38	884	2284
Dcitr04g16280.1.1	494	180	674	Q95SF2_DROME	532	102	634	0.0	78.424	72	86.30	1	38	880	2273
Dcitr04g16740.1.1	95	30	125	FBRL_DROME	95	109	204	1.92e-53	84.375	77	89.58	0	0	170	431
Dcitr04g16760.1.1	231	88	319	FBRL_DROME	231	109	340	6.12e-150	86.638	71	92.24	0	0	424	1090
Dcitr04g16830.1.1	108	18	126	H2B_LITVA	103	13	116	1.12e-64	87.156	86	91.74	1	5	191	486
Dcitr04g16830.1.1	90	36	126	H2B_DROME	90	33	123	4.20e-62	97.802	72	100.00	0	0	185	469
Dcitr04g16840.1.1	88	16	104	H1_DROME	91	37	128	2.55e-37	71.739	76	80.43	1	3	126	316
Dcitr04g16850.1.1	135	1	136	H3_DROME	135	1	136	4.37e-97	100.000	99	100.00	0	0	274	701
Dcitr04g16850.1.1	135	1	136	H33_DROME	135	1	136	2.54e-94	97.059	99	99.26	0	0	267	683
Dcitr04g17010.1.1	135	1	136	H3_DROME	135	1	136	4.37e-97	100.000	99	100.00	0	0	274	701
Dcitr04g17010.1.1	135	1	136	H33_DROME	135	1	136	2.54e-94	97.059	99	99.26	0	0	267	683
Dcitr04g17050.1.1	135	1	136	H3_DROME	135	1	136	4.37e-97	100.000	99	100.00	0	0	274	701
Dcitr04g17050.1.1	135	1	136	H33_DROME	135	1	136	2.54e-94	97.059	99	99.26	0	0	267	683
Dcitr05g01010.1.1	332	3	335	Q0E8E8_DROME	350	4	354	2.63e-167	70.085	98	79.49	1	18	469	1207
Dcitr05g01350.1.1	223	1	224	KCNAS_DROME	223	312	535	5.02e-151	96.429	85	99.55	0	0	435	1119
Dcitr05g01370.1.1	299	8	307	KCNAS_DROME	298	62	360	0.0	91.333	97	94.33	1	1	552	1423
Dcitr05g01380.1.1	142	1	143	KCNAS_DROME	142	393	535	6.48e-92	96.503	79	100.00	0	0	280	716
Dcitr05g01820.1.1	239	1	240	FRY_DROME	244	696	940	3.60e-113	73.984	94	84.15	3	7	367	942
Dcitr05g01850.1.1	143	1	144	Q7PLT4_DROME	143	1	144	1.46e-84	78.472	87	89.58	0	0	245	626
Dcitr05g02120.1.1	417	1	418	ARP3_DROME	417	1	418	0.0	88.756	99	94.02	0	0	768	1983
Dcitr05g02280.1.1	217	516	733	CNGA_DROME	217	397	614	3.13e-109	77.982	81	88.99	0	0	348	893
Dcitr05g02330.1.1	144	1	145	Q9XZ03_DROME	144	1	145	7.49e-74	71.034	99	84.83	0	0	216	551
Dcitr05g02330.1.1	144	1	145	M9PFR6_DROME	144	1	145	3.63e-73	71.034	99	84.83	0	0	216	550
Dcitr05g02640.1.1	94	1	95	Q9VTW6_DROME	94	1	95	6.77e-64	94.737	99	97.89	0	0	187	475
Dcitr05g02680.1.1	94	1	95	Q9VTW6_DROME	94	1	95	6.77e-64	94.737	99	97.89	0	0	187	475
Dcitr05g02850.1.1	198	1	199	UBCD4_DROME	198	1	199	2.26e-108	75.377	99	88.44	0	0	308	789
Dcitr05g02870.1.1	198	1	199	UBCD4_DROME	198	1	199	3.24e-108	75.377	99	88.44	0	0	308	788
Dcitr05g02910.1.1	62	183	245	TF2AA_DROME	63	303	366	8.88e-33	78.125	96	92.19	1	1	121	304
Dcitr05g02970.1.1	189	1	190	NCAH_DROME	189	1	190	1.82e-138	94.737	99	98.95	0	0	383	984
Dcitr05g02990.1.1	406	66	472	SEPT2_DROME	404	15	419	0.0	81.818	86	93.12	1	2	715	1845
Dcitr05g02990.1.1	410	62	472	Q7KLG8_DROME	408	14	422	0.0	72.019	87	87.59	1	2	649	1673
Dcitr05g03030.1.1	189	1	190	NCAH_DROME	189	1	190	1.82e-138	94.737	99	98.95	0	0	383	984
Dcitr05g03060.1.1	185	1	186	NCAH_DROME	185	1	186	3.65e-133	93.548	80	97.85	0	0	372	954
Dcitr05g03100.1.1	406	26	432	SEPT2_DROME	404	15	419	0.0	81.818	94	93.12	1	2	715	1846
Dcitr05g03100.1.1	415	17	432	Q7KLG8_DROME	413	9	422	0.0	71.394	96	86.78	1	2	649	1673
Dcitr05g03100.1.2	406	66	472	SEPT2_DROME	404	15	419	0.0	81.818	86	93.12	1	2	715	1845
Dcitr05g03100.1.2	410	62	472	Q7KLG8_DROME	408	14	422	0.0	72.019	87	87.59	1	2	649	1673
Dcitr05g03100.1.3	406	66	472	SEPT2_DROME	404	15	419	0.0	81.818	86	93.12	1	2	715	1845
Dcitr05g03100.1.3	410	62	472	Q7KLG8_DROME	408	14	422	0.0	72.019	87	87.59	1	2	649	1673
Dcitr05g03220.1.1	165	11	176	ARMET_DROME	167	6	173	3.51e-82	71.429	94	80.36	1	2	240	612
Dcitr05g03390.1.1	243	1	244	ADT_DROME	243	69	312	8.97e-155	83.673	99	91.43	2	2	432	1110
Dcitr05g03420.1.1	153	1	154	O76926_DROME	153	1	154	2.67e-86	72.078	92	86.36	0	0	252	644
Dcitr05g03420.1.1	153	1	154	Q8SXR2_DROME	153	1	154	3.16e-84	70.779	92	87.01	0	0	252	644
Dcitr05g03420.1.1	153	1	154	Q9VPH4_DROME	153	1	154	3.44e-84	70.779	92	87.01	0	0	252	643
Dcitr05g03480.1.1	293	20	313	ADT_DROME	293	19	312	0.0	83.390	93	91.19	2	2	515	1326
Dcitr05g03650.1.1	21	124	145	DIP2_DROME	21	25	46	0.040	72.727	94	81.82	0	0	38.5	88
Dcitr05g03670.1.2	918	1	919	DIP2_DROME	950	639	1589	0.0	73.326	97	84.10	7	42	1433	3710
Dcitr05g03750.1.1	459	19	478	TRC_DROME	452	6	458	0.0	85.652	94	91.74	3	7	818	2113
Dcitr05g03770.1.1	166	18	184	TRC_DROME	166	6	172	2.67e-94	84.431	88	88.62	0	0	281	719
Dcitr05g03770.1.2	166	18	184	TRC_DROME	166	6	172	2.67e-94	84.431	88	88.62	0	0	281	719
Dcitr05g03950.1.1	127	1	128	FBXW7_DROME	127	1192	1319	3.04e-76	89.844	98	96.88	0	0	244	623
Dcitr05g04270.1.1	273	15	288	Q7K3T4_DROME	273	20	293	6.22e-158	70.803	95	85.77	0	0	441	1134
Dcitr05g04270.1.2	273	31	304	Q7K3T4_DROME	273	20	293	6.37e-158	70.803	90	85.77	0	0	441	1135
Dcitr05g04290.1.1	116	2	118	E1NZB4_DROME	116	233	349	2.63e-60	71.795	94	82.91	0	0	188	477
Dcitr05g04290.1.1	116	2	118	Q9VYI0_DROME	116	236	352	3.16e-60	71.795	94	82.91	0	0	188	477
Dcitr05g04560.1.1	344	89	433	Q9VM69_DROME	344	98	442	0.0	76.522	74	88.12	0	0	561	1447
Dcitr05g04560.1.1	344	89	433	Q9U5W4_DROME	344	98	442	0.0	76.232	74	88.12	0	0	560	1444
Dcitr05g04580.1.1	151	1	152	RS11_DROME	154	1	155	7.02e-82	75.484	99	85.81	1	3	237	605
Dcitr05g04590.1.1	443	280	723	HSP83_BOMMO	441	275	716	0.0	83.333	91	93.24	1	2	766	1979
Dcitr05g04590.1.1	217	1	218	HSP83_BOMMO	216	1	217	1.77e-122	84.862	91	93.12	1	1	382	980
Dcitr05g04590.1.1	443	280	723	HSP83_DROME	442	275	717	0.0	78.829	91	89.41	1	1	745	1923
Dcitr05g04590.1.1	217	1	218	HSP83_DROME	209	1	210	7.76e-118	83.486	91	90.83	1	8	369	948
Dcitr05g04600.1.1	152	17	169	NDKA_DROME	152	1	153	8.08e-91	77.124	90	90.20	0	0	261	666
Dcitr05g04670.1.1	425	218	643	HSP83_BOMMO	423	293	716	0.0	85.446	100	95.54	1	2	734	1895
Dcitr05g04670.1.1	226	1	227	HSP83_BOMMO	225	1	226	3.19e-123	82.379	100	90.75	1	1	381	978
Dcitr05g04670.1.1	425	218	643	HSP83_DROME	424	293	717	0.0	80.047	100	91.55	1	1	726	1874
Dcitr05g04670.1.1	228	1	229	HSP83_DROME	220	1	221	7.00e-119	80.349	100	88.65	1	8	370	949
Dcitr05g04700.1.1	441	1	442	Q9VM69_DROME	441	1	442	0.0	75.792	93	87.10	0	0	671	1731
Dcitr05g04700.1.1	391	453	844	Q9VM69_DROME	389	64	453	0.0	73.724	93	85.20	1	2	588	1517
Dcitr05g04700.1.1	441	1	442	Q9U5W4_DROME	441	1	442	0.0	75.566	93	87.10	0	0	671	1730
Dcitr05g04700.1.1	391	453	844	Q9U5W4_DROME	388	64	452	0.0	73.469	93	85.20	1	3	588	1515
Dcitr05g04710.1.1	164	1	165	Q9VXE8_DROME	164	1	165	4.30e-109	86.061	99	95.15	0	0	307	786
Dcitr05g04710.1.1	162	1	163	Q9N9Z5_DROME	162	1	163	4.82e-103	83.436	98	92.64	0	0	293	750
Dcitr05g04840.1.1	322	1	323	VPS26_DROME	328	1	329	3.44e-179	73.636	90	82.12	2	8	505	1300
Dcitr05g04870.1.1	322	1	323	VPS26_DROME	328	1	329	1.10e-180	73.939	90	82.42	2	8	509	1310
Dcitr05g04900.1.1	153	1	154	ASF1_DROME	153	1	154	1.66e-92	79.221	74	90.91	0	0	269	687
Dcitr05g04900.1.2	153	1	154	ASF1_DROME	153	1	154	1.66e-92	79.221	74	90.91	0	0	269	687
Dcitr05g04950.1.1	126	4	130	ISCA1_DROME	127	3	130	9.34e-72	75.781	97	92.19	1	1	210	534
Dcitr05g05000.1.1	190	1	191	CDC42_DROME	190	1	191	7.38e-135	95.288	99	96.86	0	0	374	961
Dcitr05g05210.1.1	401	225	626	HSP83_BOMMO	400	287	687	0.0	83.831	87	91.79	1	1	685	1768
Dcitr05g05210.1.1	214	11	225	HSP83_BOMMO	214	12	226	5.23e-124	86.047	87	94.88	0	0	385	989
Dcitr05g05210.1.1	404	225	629	HSP83_DROME	403	287	690	0.0	78.765	87	88.15	1	1	670	1728
Dcitr05g05210.1.1	215	11	226	HSP83_DROME	215	5	220	1.88e-122	84.722	87	94.44	0	0	381	978
Dcitr05g06160.1.1	359	640	999	MYSP1_DROME	359	517	876	3.57e-160	71.944	74	86.39	0	0	493	1270
Dcitr05g06170.1.1	605	1	606	MYSP1_DROME	607	1	608	0.0	71.264	99	85.22	2	4	752	1941
Dcitr05g06320.1.1	513	1	514	MYSP1_DROME	515	1	516	0.0	70.213	99	84.53	2	4	614	1583
Dcitr05g06410.1.1	180	106	286	Q9VZK2_DROME	181	425	606	7.20e-109	85.870	72	91.30	2	5	329	844
Dcitr05g06410.1.1	44	47	91	Q9VZK2_DROME	53	228	281	6.90e-14	72.222	72	75.93	2	9	71.6	174
Dcitr05g06410.1.1	180	106	286	Q24140_DROME	179	425	604	1.20e-104	84.239	72	90.22	3	7	319	817
Dcitr05g06410.1.1	44	47	91	Q24140_DROME	53	228	281	7.97e-14	72.222	72	75.93	2	9	71.2	173
Dcitr05g06480.1.1	180	106	286	Q9VZK2_DROME	181	425	606	7.20e-109	85.870	72	91.30	2	5	329	844
Dcitr05g06480.1.1	44	47	91	Q9VZK2_DROME	53	228	281	6.90e-14	72.222	72	75.93	2	9	71.6	174
Dcitr05g06480.1.1	180	106	286	Q24140_DROME	179	425	604	1.20e-104	84.239	72	90.22	3	7	319	817
Dcitr05g06480.1.1	44	47	91	Q24140_DROME	53	228	281	7.97e-14	72.222	72	75.93	2	9	71.2	173
Dcitr05g06730.1.1	133	1	134	RL32_DROME	133	1	134	6.84e-74	76.119	99	86.57	0	0	216	549
Dcitr05g06760.1.1	133	1	134	RL32_DROME	133	1	134	6.84e-74	76.119	99	86.57	0	0	216	549
Dcitr05g07050.1.1	400	2	402	CDK8_DROME	414	1	415	0.0	82.212	97	87.74	2	16	692	1786
Dcitr05g07140.1.1	122	100	222	Q9VRW4_DROME	122	124	246	2.01e-54	72.358	80	89.43	0	0	201	511
Dcitr05g07140.1.1	122	100	222	Q7YU35_DROME	122	124	246	1.92e-54	72.358	80	89.43	0	0	201	511
Dcitr05g07160.1.1	190	4	194	Q9VD29_DROME	190	3	193	2.04e-98	73.822	98	82.72	0	0	282	722
Dcitr05g07160.1.1	179	15	194	Q9NFN8_DROME	171	26	197	1.14e-88	71.196	92	80.98	2	16	258	658
Dcitr05g07160.1.1	154	40	194	Q95SY7_DROME	154	1	155	6.70e-80	72.903	79	83.87	0	0	234	597
Dcitr05g07350.1.1	368	350	718	GLNA2_DROME	368	1	369	0.0	73.713	99	85.91	0	0	591	1524
Dcitr05g07350.1.1	354	1	355	GLNA2_DROME	361	1	362	0.0	70.166	99	82.87	1	7	542	1397
Dcitr05g07410.1.1	213	8	221	RS5A_DROME	214	14	228	1.53e-134	85.116	96	91.63	1	1	376	966
Dcitr05g07440.1.1	152	1	153	AP3D_DROME	152	14	166	4.94e-91	84.967	98	93.46	0	0	284	727
Dcitr05g07500.1.1	206	19	225	VINC_DROME	196	764	960	6.42e-93	71.429	92	82.86	4	16	291	745
Dcitr05g07510.1.1	72	1	73	VINC_DROME	81	1	82	1.69e-36	78.049	94	82.93	1	9	128	322
Dcitr05g07660.1.1	224	44	268	Q9VZU4_DROME	222	28	250	3.54e-131	77.333	78	86.67	2	2	372	955
Dcitr05g07970.1.1	121	8	129	Q9VH97_DROME	121	4443	4564	2.47e-61	80.328	94	81.97	0	0	204	519
Dcitr05g07970.1.1	42	129	171	Q9VH97_DROME	42	4625	4667	3.62e-23	97.674	94	100.00	0	0	95.1	235
Dcitr05g07970.1.1	121	8	129	A0A0B4K614_DROME	121	4467	4588	2.52e-61	80.328	94	81.97	0	0	204	519
Dcitr05g07970.1.1	42	129	171	A0A0B4K614_DROME	42	4649	4691	3.62e-23	97.674	94	100.00	0	0	95.1	235
Dcitr05g07970.1.1	121	8	129	A0A0B4LH20_DROME	121	4475	4596	2.64e-61	80.328	94	81.97	0	0	204	518
Dcitr05g07970.1.1	42	129	171	A0A0B4LH20_DROME	42	4657	4699	3.58e-23	97.674	94	100.00	0	0	95.1	235
Dcitr05g07980.1.1	2437	1	2438	A0A0B4K648_DROME	2430	2125	4555	0.0	77.691	99	86.37	6	17	3932	10198
Dcitr05g07980.1.1	2437	1	2438	Q9VH97_DROME	2430	2117	4547	0.0	77.691	99	86.37	6	17	3931	10195
Dcitr05g07980.1.1	2437	1	2438	A0A0B4K614_DROME	2454	2117	4571	0.0	77.073	99	85.69	5	27	3925	10178
Dcitr05g08900.1.1	173	34	207	SQH_DROME	173	1	174	3.38e-119	90.805	84	97.13	0	0	335	858
Dcitr05g09140.1.1	566	2	568	NELFB_DROME	576	13	589	0.0	76.817	99	89.27	5	12	903	2333
Dcitr05g09180.1.1	744	113	857	Q9VUY1_DROME	738	155	893	0.0	74.263	87	86.19	4	8	1139	2946
Dcitr05g09180.1.1	744	113	857	Q8MQK2_DROME	738	144	882	0.0	74.263	87	86.19	4	8	1139	2945
Dcitr05g09180.1.1	744	113	857	Q8IQN2_DROME	738	84	822	0.0	74.263	87	86.19	4	8	1136	2938
Dcitr05g09560.1.1	397	1	398	FLOT1_DROME	418	1	419	0.0	75.418	98	89.26	3	21	616	1588
Dcitr05g09570.1.1	304	1	305	FLOT1_DROME	304	115	419	3.85e-160	75.738	82	95.08	0	0	455	1171
Dcitr05g10420.1.1	467	8	475	UGDH_DROME	468	3	471	0.0	77.542	97	87.71	3	7	762	1968
Dcitr05g10470.1.1	108	43	151	EGFR_DROME	108	94	202	4.83e-54	76.147	81	88.07	0	0	182	461
Dcitr05g10750.1.1	218	1	219	Q9VBY7_DROME	194	1	195	2.81e-105	77.626	98	80.82	1	24	301	771
Dcitr05g10790.1.1	447	1	448	Q9V400_DROME	447	1	448	0.0	71.652	99	85.49	0	0	706	1823
Dcitr05g10790.1.1	447	1	448	Q9NHC7_DROME	447	1	448	0.0	70.982	99	85.04	0	0	698	1802
Dcitr05g10970.1.1	297	1	298	IF2A_DROME	297	1	298	6.31e-162	72.819	99	86.91	0	0	453	1166
Dcitr05g10970.1.1	298	1	299	M9T5Z6_LITVA	298	1	299	2.64e-161	71.906	100	86.62	0	0	451	1161
Dcitr05g11000.1.1	91	1	92	M9T5Z6_LITVA	91	1	92	3.48e-54	89.130	98	97.83	0	0	170	431
Dcitr05g11000.1.1	89	1	90	IF2A_DROME	89	1	90	1.24e-52	91.111	96	95.56	0	0	166	421
Dcitr05g11240.1.1	89	1	90	O97102_DROME	87	1	88	1.90e-47	77.778	78	86.67	1	2	146	369
Dcitr05g11540.1.1	258	1	259	RS4_DROME	258	1	259	1.40e-163	81.853	98	91.12	0	0	453	1165
Dcitr05g11560.1.1	258	1	259	RS4_DROME	258	1	259	1.40e-163	81.853	98	91.12	0	0	453	1165
Dcitr05g11630.1.1	12	110	122	KLFL_DROME	12	236	248	2.7	92.308	73	100.00	0	0	28.5	62
Dcitr05g11890.1.1	96	1	97	Q9VWX8_DROME	107	1	108	1.53e-57	77.778	98	85.19	1	11	174	442
Dcitr05g11890.1.1	96	1	97	FREQ_DROME	107	1	108	1.49e-56	77.778	98	85.19	1	11	172	435
Dcitr05g11910.1.1	98	1	99	Q9VWX8_DROME	98	77	175	6.88e-68	95.960	97	100.00	0	0	201	510
Dcitr05g11910.1.1	98	1	99	FREQ_DROME	98	77	175	4.13e-66	94.949	97	97.98	0	0	196	499
Dcitr05g11930.1.1	275	1	276	Q7KTS4_DROME	279	1	280	1.33e-153	73.929	94	83.93	1	4	437	1124
Dcitr05g11930.1.1	275	1	276	Q9VNC2_DROME	279	1	280	7.69e-153	73.571	94	83.93	1	4	435	1119
Dcitr05g11970.1.1	416	1	417	ACADM_DROME	409	7	416	0.0	75.952	99	85.48	3	13	664	1712
Dcitr05g11980.1.1	80	3	83	ACADM_DROME	80	336	416	1.13e-38	75.309	94	88.89	0	0	132	331
Dcitr05g12050.1.1	357	111	468	PKN_DROME	362	828	1190	0.0	83.196	76	90.63	2	5	612	1579
Dcitr05g12050.1.2	357	47	404	PKN_DROME	362	828	1190	0.0	83.196	88	90.63	2	5	610	1574
Dcitr05g12130.1.1	533	51	584	ABL_DROME	527	112	639	0.0	74.250	85	80.25	8	72	845	2184
Dcitr05g12130.1.1	48	619	667	ABL_DROME	48	209	257	8.99e-21	81.633	85	91.84	0	0	97.4	241
Dcitr05g12180.1.1	231	219	450	O17432_DROME	234	15	249	4.18e-130	80.426	88	85.96	1	3	382	980
Dcitr05g12180.1.1	180	24	204	O17432_DROME	178	15	193	3.32e-90	76.243	88	85.64	1	2	280	715
Dcitr05g12280.1.1	357	839	1196	PKN_DROME	362	828	1190	0.0	83.196	92	90.63	2	5	622	1604
Dcitr05g12600.1.1	210	1	211	A0A0B4K738_DROME	210	27	237	9.05e-114	78.199	99	89.57	0	0	353	906
Dcitr05g12600.1.1	210	1	211	A0A0B4KF87_DROME	210	77	287	1.83e-113	78.199	99	89.57	0	0	355	910
Dcitr05g12600.1.1	210	1	211	A0A0B4KFK3_DROME	210	31	241	2.26e-113	78.199	99	89.57	0	0	353	907
Dcitr05g12650.1.1	356	1	357	A0A0B4KF87_DROME	356	289	645	0.0	94.678	100	98.32	0	0	731	1887
Dcitr05g12650.1.1	356	1	357	A8DY93_DROME	356	306	662	0.0	94.678	100	98.32	0	0	731	1886
Dcitr05g12650.1.1	356	1	357	A8DY94_DROME	356	306	662	0.0	94.678	100	98.32	0	0	731	1886
Dcitr05g12800.1.1	556	38	594	A0A0C4DHC4_DROME	556	25	581	0.0	88.510	94	94.79	0	0	1066	2757
Dcitr05g12800.1.1	302	668	970	A0A0C4DHC4_DROME	302	973	1275	0.0	90.099	94	97.03	0	0	589	1518
Dcitr05g12800.1.1	302	1113	1415	A0A0C4DHC4_DROME	302	973	1275	0.0	90.099	94	97.03	0	0	589	1518
Dcitr05g12800.1.1	556	38	594	A0A0B4KEQ3_DROME	556	25	581	0.0	88.510	94	94.79	0	0	1065	2754
Dcitr05g12800.1.1	302	668	970	A0A0B4KEQ3_DROME	302	973	1275	2.93e-180	90.099	94	97.03	0	0	588	1516
Dcitr05g12800.1.1	302	1113	1415	A0A0B4KEQ3_DROME	302	973	1275	2.93e-180	90.099	94	97.03	0	0	588	1516
Dcitr05g12800.1.1	556	38	594	A0A0B4KEJ9_DROME	556	25	581	0.0	88.510	94	94.79	0	0	1065	2753
Dcitr05g12800.1.1	302	668	970	A0A0B4KEJ9_DROME	302	973	1275	2.95e-180	90.099	94	97.03	0	0	588	1515
Dcitr05g12800.1.1	302	1113	1415	A0A0B4KEJ9_DROME	302	973	1275	2.95e-180	90.099	94	97.03	0	0	588	1515
Dcitr05g13130.1.1	207	1	208	O76742_DROME	206	1	207	5.91e-118	75.000	99	88.46	1	1	333	853
Dcitr05g13160.1.1	207	6	213	O76742_DROME	206	1	207	8.23e-118	75.000	97	88.46	1	1	333	853
Dcitr05g13170.1.1	207	1	208	O76742_DROME	206	1	207	5.91e-118	75.000	99	88.46	1	1	333	853
Dcitr05g13410.1.1	757	38	795	Q7KJA9_DROME	785	272	1057	0.0	78.807	96	87.56	2	32	1318	3410
Dcitr05g13410.1.1	705	38	743	Q9Y148_DROME	733	272	1005	0.0	80.842	89	88.86	2	32	1262	3265
Dcitr05g13430.1.1	249	5	254	Q9Y148_DROME	254	20	274	7.55e-147	82.745	94	89.41	2	5	436	1120
Dcitr05g13430.1.1	249	5	254	Q7KJA9_DROME	254	20	274	3.63e-146	82.745	94	89.41	2	5	435	1118
Dcitr05g13650.1.1	461	1	462	CISY_DROME	463	1	464	0.0	78.065	99	88.39	2	4	772	1993
Dcitr05g13750.1.1	230	17	247	E1JIC9_DROME	228	9	237	1.30e-112	70.259	92	83.19	3	4	323	827
Dcitr05g13790.1.1	50	9	59	GLR1_DROME	50	43	93	1.44e-25	86.275	72	94.12	0	0	97.1	240
Dcitr05g13910.1.1	328	1	329	Q9Y162_DROME	328	114	442	0.0	77.812	99	87.84	0	0	539	1389
Dcitr05g13920.1.1	461	114	575	GTR1_DROME	472	4	476	0.0	77.378	80	87.10	1	11	736	1899
Dcitr05g13930.1.1	433	2	435	Q9Y162_DROME	437	5	442	0.0	72.374	99	83.56	1	4	611	1576
Dcitr05g13950.1.1	474	150	624	GTR1_DROME	474	2	476	0.0	79.158	76	88.84	0	0	761	1966
Dcitr05g14010.1.1	294	7	301	GTR1_DROME	287	189	476	7.00e-163	78.305	98	87.46	1	7	489	1258
Dcitr05g14140.1.1	136	1	137	GBRB_DROME	136	210	346	1.23e-80	94.891	90	97.81	0	0	248	634
Dcitr05g14190.1.1	49	5	54	IF2B_DROME	49	208	257	7.54e-27	90.000	78	94.00	0	0	97.8	242
Dcitr05g14270.1.1	181	1	182	UBC12_DROME	178	1	179	6.18e-108	80.220	99	89.01	1	3	305	782
Dcitr05g14280.1.1	181	1	182	UBC12_DROME	178	1	179	6.18e-108	80.220	99	89.01	1	3	305	782
Dcitr05g14550.1.1	211	16	227	Q9V3V2_DROME	209	7	216	1.15e-105	70.892	93	81.22	3	4	303	776
Dcitr05g15030.1.1	88	1	89	Q9VRT7_DROME	88	1	89	9.21e-50	85.393	96	93.26	0	0	151	382
Dcitr05g15630.1.1	30	11	41	X2JAG8_DROME	30	155	185	3.64e-07	77.419	86	90.32	0	0	53.1	126
Dcitr05g15630.1.1	30	11	41	Q9Y145_DROME	30	155	185	3.63e-07	77.419	86	90.32	0	0	53.1	126
Dcitr05g15630.1.1	30	11	41	M9PGI7_DROME	30	155	185	3.60e-07	77.419	86	90.32	0	0	53.1	126
Dcitr05g15800.1.1	168	3	171	Q24216_DROME	168	7	175	6.23e-85	73.964	99	85.80	0	0	264	675
Dcitr05g15820.1.1	364	1	365	L0MPN7_DROME	372	1	373	0.0	74.934	83	82.32	4	20	590	1522
Dcitr05g15820.1.3	364	1	365	L0MPN7_DROME	372	1	373	0.0	74.934	83	82.32	4	20	590	1522
Dcitr05g16040.1.1	664	38	702	ACSA_DROME	662	4	666	0.0	74.024	94	85.59	2	4	1063	2750
Dcitr05g16040.1.2	664	38	702	ACSA_DROME	662	4	666	0.0	74.024	94	85.59	2	4	1063	2750
Dcitr05g16350.1.1	109	1	110	ETIF1_DROME	109	1	110	5.56e-75	91.818	99	97.27	0	0	216	551
Dcitr05g16390.1.1	109	1	110	ETIF1_DROME	109	1	110	5.56e-75	91.818	99	97.27	0	0	216	551
Dcitr05g16900.1.1	183	46	229	Q8T6I0_DROME	183	14	197	6.03e-98	73.913	80	86.41	0	0	294	753
Dcitr05g16900.1.1	194	35	229	Q8T8W3_DROME	194	9	203	6.80e-98	70.256	85	83.08	0	0	295	754
Dcitr05g16900.1.1	183	46	229	Q8IGN0_DROME	183	14	197	9.19e-98	73.370	80	86.41	0	0	294	752
Dcitr05g17010.1.1	245	35	280	Q8T6I0_DROME	245	3	248	1.45e-130	71.138	85	85.37	0	0	380	976
Dcitr05g17010.1.1	245	35	280	Q8T8W3_DROME	245	9	254	2.14e-130	71.138	85	85.37	0	0	380	976
Dcitr05g17010.1.1	245	35	280	Q8IGN0_DROME	245	3	248	2.50e-130	70.732	85	85.37	0	0	380	975
Dcitr06g01200.1.1	438	1	439	TBA1_DROME	438	1	439	0.0	96.811	97	99.09	0	0	875	2260
Dcitr06g01200.1.1	449	1	450	TBA2_DROME	448	1	449	0.0	95.556	99	97.33	1	1	874	2257
Dcitr06g01200.1.1	438	1	439	TBA3_DROME	438	1	439	0.0	96.355	97	98.86	0	0	872	2252
Dcitr06g01280.1.1	218	1	219	DDX1_DROME	218	505	723	1.41e-117	70.776	96	86.30	0	0	350	899
Dcitr06g01520.1.1	121	1	122	H2AV_DROME	121	1	122	2.47e-82	98.361	95	100.00	0	0	237	604
Dcitr06g01680.1.1	172	1	173	Q9VWF5_DROME	172	1	173	1.04e-105	81.503	98	87.86	0	0	299	766
Dcitr06g01680.1.1	166	1	167	M9PI14_DROME	166	1	167	4.47e-103	82.036	95	88.62	0	0	293	749
Dcitr06g01780.1.1	172	1	173	Q9VWF5_DROME	172	1	173	1.04e-105	81.503	98	87.86	0	0	299	766
Dcitr06g01780.1.1	166	1	167	M9PI14_DROME	166	1	167	4.47e-103	82.036	95	88.62	0	0	293	749
Dcitr06g01990.1.1	237	37	274	X2JCM1_DROME	237	1154	1391	9.38e-136	77.311	85	91.60	0	0	422	1086
Dcitr06g01990.1.1	237	37	274	M9MRX4_DROME	237	1154	1391	1.65e-135	77.311	85	91.60	0	0	422	1084
Dcitr06g01990.1.1	237	37	274	A8JNM6_DROME	237	1154	1391	1.72e-134	77.311	85	91.60	0	0	419	1076
Dcitr06g02070.1.1	258	1	259	PCNA_DROME	258	1	259	2.93e-155	78.378	99	89.19	0	0	432	1110
Dcitr06g02090.1.1	199	1	200	Q9VWG1_DROME	181	1	182	7.14e-99	71.000	99	81.00	1	18	283	725
Dcitr06g02090.1.1	199	1	200	Q8IQW5_DROME	190	1	191	8.04e-97	72.000	99	84.00	2	9	278	712
Dcitr06g02090.1.2	189	1	190	Q9VWG1_DROME	181	1	182	1.70e-101	74.737	99	85.79	1	8	290	741
Dcitr06g02090.1.2	189	1	190	Q8IQW5_DROME	190	1	191	2.61e-98	76.562	99	87.50	2	3	282	721
Dcitr06g02160.1.1	139	1	140	RS14A_DROME	139	1	140	3.85e-94	92.857	83	97.14	0	0	269	687
Dcitr06g02290.1.1	258	1	259	PCNA_DROME	258	1	259	2.93e-155	78.378	99	89.19	0	0	432	1110
Dcitr06g02310.1.1	258	1	259	PCNA_DROME	258	1	259	2.93e-155	78.378	99	89.19	0	0	432	1110
Dcitr06g02350.1.1	322	5	327	MOEH_DROME	344	155	499	1.26e-171	73.487	98	83.29	3	26	488	1256
Dcitr06g02500.1.1	389	27	416	MOEH_DROME	389	51	440	0.0	80.513	90	90.51	0	0	656	1692
Dcitr06g02510.1.1	72	2	74	MOEH_DROME	72	1	73	3.97e-35	78.082	89	86.30	0	0	124	310
Dcitr06g02520.1.1	289	1	290	MOEH_DROME	292	286	578	3.03e-134	74.237	99	85.42	2	7	391	1005
Dcitr06g02530.1.1	70	2	72	MOEH_DROME	70	1	71	3.13e-34	80.282	76	87.32	0	0	122	306
Dcitr06g02700.1.1	91	1	92	RNK_DROME	90	1	91	1.27e-44	71.739	94	81.52	1	1	139	349
Dcitr06g02790.1.1	419	1	420	AP2A_DROME	420	1	421	0.0	90.499	100	95.25	1	1	793	2048
Dcitr06g02790.1.2	419	1	420	AP2A_DROME	420	1	421	0.0	90.499	100	95.25	1	1	793	2048
Dcitr06g02840.1.1	932	1	933	AP2A_DROME	939	1	940	0.0	80.867	99	88.79	5	19	1583	4099
Dcitr06g02960.1.1	132	1	133	UBCD2_DROME	132	80	212	6.71e-97	97.744	97	99.25	0	0	277	709
Dcitr06g02960.1.1	123	10	133	UBCD1_DROME	123	4	127	4.06e-59	70.161	91	77.42	0	0	179	453
Dcitr06g03030.1.1	83	1	84	MSPS_DROME	83	1	84	3.30e-39	75.000	99	85.71	0	0	136	343
Dcitr06g03480.1.1	72	1	73	UBL5_DROME	72	1	73	7.25e-46	93.151	99	95.89	0	0	140	352
Dcitr06g03500.1.1	72	1	73	UBL5_DROME	72	1	73	7.25e-46	93.151	99	95.89	0	0	140	352
Dcitr06g03820.1.1	175	1	176	Q9NHX7_DROME	176	104	280	3.38e-94	70.621	97	88.14	1	1	274	701
Dcitr06g03820.1.1	175	1	176	Q7K148_DROME	176	104	280	3.50e-94	70.621	97	88.14	1	1	274	701
Dcitr06g03890.1.1	130	5	135	RS16_DROME	130	18	148	1.53e-83	88.550	96	96.18	0	0	240	613
Dcitr06g03910.1.1	139	11	150	RS16_DROME	139	9	148	9.24e-89	87.143	93	96.43	0	0	254	649
Dcitr06g04140.1.1	108	1	109	MP20_DROME	108	76	184	6.04e-67	83.486	99	96.33	0	0	199	505
Dcitr06g04480.1.1	236	1	237	CYFIP_DROME	236	585	821	6.03e-143	83.544	99	92.41	0	0	431	1107
Dcitr06g04500.1.1	494	3	497	CYFIP_DROME	494	2	496	0.0	85.859	99	93.54	0	0	896	2316
Dcitr06g04620.1.5	65	1	66	CAD_DROME	65	269	334	8.81e-33	84.848	76	90.91	0	0	116	291
Dcitr06g04620.1.6	65	1	66	CAD_DROME	65	269	334	8.81e-33	84.848	76	90.91	0	0	116	291
Dcitr06g04620.1.7	65	1	66	CAD_DROME	65	269	334	8.81e-33	84.848	76	90.91	0	0	116	291
Dcitr06g04620.1.8	65	1	66	CAD_DROME	65	269	334	8.81e-33	84.848	76	90.91	0	0	116	291
Dcitr06g05370.1.1	93	1	94	Q9W229_DROME	93	1	94	7.07e-49	73.404	81	87.23	0	0	151	382
Dcitr06g05380.1.1	70	1	71	Q9W229_DROME	70	24	94	1.77e-35	73.239	87	85.92	0	0	116	290
Dcitr06g05460.1.1	239	1	240	RS3_DROME	244	1	245	1.09e-138	78.776	99	86.12	2	5	388	997
Dcitr06g05490.1.1	188	1	189	RS3_DROME	192	53	245	7.50e-107	78.756	98	84.46	1	4	305	782
Dcitr06g05690.1.1	251	45	296	M9PDR2_DROME	251	88	339	5.35e-174	95.635	80	98.41	0	0	514	1324
Dcitr06g05690.1.1	251	45	296	Q9W0Q1_DROME	251	172	423	1.36e-173	95.635	80	98.41	0	0	515	1327
Dcitr06g05740.1.1	83	13	96	SCAL_DROME	86	40	126	6.61e-40	78.652	79	86.52	4	7	136	343
Dcitr06g06040.1.1	190	4	194	Q9VD29_DROME	190	3	193	3.39e-116	81.675	98	90.05	0	0	327	839
Dcitr06g06040.1.1	190	4	194	Q9NFN8_DROME	194	3	197	1.68e-102	72.947	98	79.71	3	28	293	749
Dcitr06g06040.1.1	154	40	194	Q95SY7_DROME	154	1	155	9.82e-89	78.065	79	88.39	0	0	256	655
Dcitr06g06050.1.1	122	38	160	RL31_DROME	122	2	124	7.18e-53	70.732	76	82.93	0	0	163	413
Dcitr06g06060.1.1	154	1	155	Q95SY7_DROME	154	1	155	4.38e-90	78.065	99	88.39	0	0	258	659
Dcitr06g06060.1.1	154	1	155	Q9VD29_DROME	154	39	193	1.45e-89	78.065	99	88.39	0	0	258	660
Dcitr06g06060.1.1	154	1	155	Q9NFN8_DROME	146	51	197	2.28e-79	72.956	99	81.76	2	16	233	593
Dcitr06g06690.1.1	126	32	158	Q9V405_DROME	126	28	154	8.82e-73	88.189	86	93.70	0	0	228	581
Dcitr06g06690.1.1	113	156	269	Q9V405_DROME	113	58	171	1.32e-70	93.860	86	97.37	0	0	223	567
Dcitr06g06700.1.1	204	1	205	Q9V405_DROME	204	209	413	2.45e-143	94.634	99	98.54	0	0	405	1040
Dcitr06g06860.1.1	260	1	261	Q9W0R0_DROME	259	1	260	2.11e-155	88.123	99	92.72	1	1	452	1162
Dcitr06g06900.1.1	260	1	261	Q9W0R0_DROME	259	1	260	2.11e-155	88.123	99	92.72	1	1	452	1162
Dcitr06g07240.1.1	133	7	140	TULP_DROME	134	326	460	2.55e-73	72.593	95	88.15	1	1	225	574
Dcitr06g07380.1.1	180	1	181	RS9_DROME	180	1	181	1.13e-121	93.923	92	97.24	0	0	341	875
Dcitr06g07430.1.1	137	1	138	RS9_DROME	137	1	138	7.67e-91	94.203	98	97.83	0	0	261	666
Dcitr06g07710.1.1	147	1	148	Q9VEA1_DROME	147	1	148	3.62e-97	88.514	99	96.62	0	0	275	704
Dcitr06g07710.1.1	147	1	148	Q9NJB4_DROME	147	1	148	1.88e-96	87.838	99	96.62	0	0	274	700
Dcitr06g07750.1.1	75	1	76	T23O_DROME	75	299	374	2.16e-36	71.053	73	86.84	0	0	126	316
Dcitr06g07780.1.1	107	1	108	Q9VEA1_DROME	107	41	148	7.42e-69	87.037	99	97.22	0	0	202	514
Dcitr06g07780.1.1	107	1	108	Q9NJB4_DROME	107	41	148	2.59e-68	86.111	99	97.22	0	0	201	510
Dcitr06g08470.1.1	274	1	275	RLA0_DROME	274	1	275	6.38e-165	79.636	87	90.18	0	0	461	1185
Dcitr06g08490.1.1	170	1	171	Q9VM50_DROME	174	1	175	8.61e-103	80.114	85	92.61	3	6	295	754
Dcitr06g08500.1.1	596	1	597	HEM_DROME	597	525	1122	0.0	75.418	99	87.63	1	1	946	2444
Dcitr06g08510.1.1	166	24	190	HEM_DROME	166	310	476	2.42e-80	74.850	86	85.03	0	0	265	677
Dcitr06g08510.1.1	139	214	353	HEM_DROME	139	578	717	4.10e-65	76.429	86	88.57	0	0	222	566
Dcitr06g08630.1.1	179	2	181	Q9VND9_DROME	179	89	268	2.10e-96	71.667	98	82.78	0	0	282	721
Dcitr06g08630.1.1	179	2	181	Q8IPQ2_DROME	179	89	268	4.30e-93	71.667	98	82.78	0	0	281	720
Dcitr06g08680.1.1	458	113	571	O18402_DROME	463	15	478	0.0	75.966	80	84.12	4	9	724	1869
Dcitr06g08680.1.1	458	113	571	Q9W4H9_DROME	463	15	478	0.0	75.966	80	84.12	4	9	724	1869
Dcitr06g08700.1.1	269	1	270	RLA0_DROME	269	1	270	1.87e-163	80.000	97	90.74	0	0	455	1171
Dcitr06g08720.1.1	173	1	174	Q9VM50_DROME	174	1	175	2.10e-109	82.286	85	94.86	1	1	311	798
Dcitr06g08730.1.1	1115	3	1118	HEM_DROME	1117	5	1122	0.0	73.614	99	86.49	2	2	1729	4477
Dcitr06g08840.1.1	160	1	161	Q9VA09_DROME	161	1	162	9.90e-83	84.663	99	89.57	2	3	284	726
Dcitr06g08840.1.1	160	1	161	Q24086_DROME	161	1	162	1.12e-82	84.663	99	89.57	2	3	283	724
Dcitr06g08860.1.1	149	1	150	Q24086_DROME	149	429	578	1.23e-78	76.000	100	89.33	0	0	246	629
Dcitr06g08860.1.1	149	1	150	Q9VA09_DROME	149	429	578	1.26e-78	76.000	100	89.33	0	0	247	630
Dcitr06g08970.1.1	532	2	534	Q9W392_DROME	532	3	535	0.0	78.424	99	90.24	0	0	875	2262
Dcitr06g09110.1.1	610	5	615	VATA2_DROME	610	4	614	0.0	90.180	99	96.89	0	0	1162	3007
Dcitr06g09110.1.1	610	5	615	VATA1_DROME	610	4	614	0.0	87.234	99	94.76	0	0	1129	2921
Dcitr06g09130.1.1	24	569	593	M9PI57_DROME	24	599	623	5.14e-09	96.000	74	100.00	0	0	58.9	141
Dcitr06g09130.1.1	24	569	593	Q9VUD5_DROME	24	599	623	5.41e-09	96.000	74	100.00	0	0	58.9	141
Dcitr06g09170.1.1	289	1	290	METK_DROME	289	118	407	4.83e-163	80.000	99	90.69	0	0	458	1179
Dcitr06g09170.1.2	395	8	403	METK_DROME	393	14	407	0.0	79.040	98	87.88	1	2	619	1595
Dcitr06g09170.1.3	395	8	403	METK_DROME	393	14	407	0.0	79.798	98	89.90	1	2	632	1630
Dcitr06g09920.1.1	187	16	203	RS7_DROME	188	4	192	2.27e-100	75.661	92	85.71	1	1	288	736
Dcitr06g09970.1.1	265	2	267	EGH_DROME	267	1	268	7.52e-141	75.093	98	86.25	2	4	403	1035
Dcitr06g10010.1.1	187	5	192	RS7_DROME	188	4	192	1.61e-100	75.661	97	85.71	1	1	288	736
Dcitr06g10130.1.1	454	2	456	EGH_DROME	456	1	457	0.0	75.711	99	86.43	1	2	712	1839
Dcitr06g10310.1.1	295	30	325	MLP2_DROME	294	199	493	1.63e-169	76.768	98	87.54	2	3	479	1234
Dcitr06g10330.1.1	480	14	494	MLP2_DROME	493	1	494	0.0	71.774	97	80.85	6	17	690	1780
Dcitr06g10330.1.1	84	14	98	MLP1_DROME	84	1	85	1.34e-37	88.235	73	91.76	0	0	132	332
Dcitr06g10460.1.1	242	3	245	Q8MRF8_DROME	242	5	247	5.20e-116	70.782	99	83.54	0	0	357	917
Dcitr06g10460.1.1	242	3	245	Q9VQR8_DROME	242	5	247	5.48e-116	70.782	99	83.54	0	0	357	917
Dcitr06g10540.1.1	148	1	149	PP2B2_DROME	153	293	446	1.83e-101	92.208	83	96.10	1	5	302	774
Dcitr06g10540.1.1	148	1	149	PP2B3_DROME	153	301	454	3.19e-101	92.208	83	96.10	1	5	302	773
Dcitr06g10540.1.1	155	1	156	PP2B1_DROME	160	267	427	2.92e-100	86.957	87	91.93	1	5	301	770
Dcitr06g10550.1.1	192	50	242	PP2B3_DROME	194	75	269	2.53e-97	73.737	78	82.32	3	8	295	755
Dcitr06g10550.1.1	183	59	242	PP2B2_DROME	185	76	261	1.10e-94	74.603	74	82.54	3	8	288	737
Dcitr06g10550.1.2	192	50	242	PP2B3_DROME	194	75	269	2.53e-97	73.737	78	82.32	3	8	295	755
Dcitr06g10550.1.2	183	59	242	PP2B2_DROME	185	76	261	1.10e-94	74.603	74	82.54	3	8	288	737
Dcitr06g10560.1.1	261	1	262	PP2B2_DROME	261	165	426	0.0	94.656	99	98.09	0	0	540	1390
Dcitr06g10560.1.1	261	1	262	PP2B3_DROME	261	173	434	0.0	93.893	99	98.09	0	0	537	1383
Dcitr06g10560.1.1	261	1	262	PP2B1_DROME	261	139	400	0.0	88.168	99	95.42	0	0	514	1323
Dcitr06g10740.1.1	135	1	136	H33_DROME	135	1	136	1.09e-96	100.000	99	100.00	0	0	273	699
Dcitr06g10740.1.1	135	1	136	H3_DROME	135	1	136	2.54e-94	97.059	99	99.26	0	0	267	683
Dcitr06g10790.1.1	135	1	136	H33_DROME	135	1	136	1.09e-96	100.000	99	100.00	0	0	273	699
Dcitr06g10790.1.1	135	1	136	H3_DROME	135	1	136	2.54e-94	97.059	99	99.26	0	0	267	683
Dcitr06g10990.1.1	52	17	69	TNNT_DROME	52	32	84	1.73e-19	73.585	82	88.68	0	0	81.6	200
Dcitr06g11010.1.1	131	68	199	TNNT_DROME	131	156	287	4.27e-72	84.848	91	91.67	0	0	223	567
Dcitr06g11010.1.1	52	17	69	TNNT_DROME	52	32	84	7.72e-18	73.585	91	88.68	0	0	80.1	196
Dcitr06g11020.1.1	156	391	547	NOI_DROME	159	330	489	4.19e-83	80.000	88	86.88	2	3	268	686
Dcitr06g11100.1.1	152	2	154	VATL_DROME	152	7	159	5.60e-95	92.157	99	98.04	0	0	271	692
Dcitr06g11110.1.1	152	2	154	VATL_DROME	152	7	159	5.60e-95	92.157	99	98.04	0	0	271	692
Dcitr06g11190.1.1	495	23	518	SLO_DROME	494	39	533	0.0	89.718	92	94.15	1	1	934	2413
Dcitr06g11210.1.1	464	30	494	SLO_DROME	467	733	1200	0.0	84.277	94	87.84	5	21	773	1995
Dcitr06g11510.1.1	112	6	118	NBEA_DROME	112	2715	2827	1.89e-71	92.920	95	97.35	0	0	230	587
Dcitr06g11520.1.1	317	15	332	NBEA_DROME	318	3148	3466	1.13e-178	76.489	95	90.91	1	1	548	1412
Dcitr06g11540.1.1	299	19	318	NBEA_DROME	299	2714	3013	1.22e-176	82.000	94	91.00	0	0	541	1395
Dcitr06g11670.1.1	209	23	232	Q9V3Q4_DROME	206	21	227	8.96e-112	71.429	88	82.86	1	3	320	820
Dcitr06g11770.1.2	149	39	188	P91608_DROSP	150	41	191	4.34e-86	77.483	79	86.75	1	1	253	647
Dcitr06g11770.1.2	149	39	188	M9PHX4_DROME	150	158	308	6.57e-86	77.483	79	86.75	1	1	257	657
Dcitr06g11770.1.2	149	39	188	O77284_DROME	150	88	238	1.33e-85	77.483	79	86.75	1	1	254	649
Dcitr06g11790.1.1	320	493	813	BRAT_DROME	354	683	1037	0.0	79.718	72	84.79	5	34	578	1491
Dcitr06g11790.1.2	320	493	813	BRAT_DROME	354	683	1037	0.0	79.718	72	84.79	5	34	578	1491
Dcitr06g11830.1.1	241	1	242	ZN330_DROME	239	1	240	1.79e-148	81.818	79	90.91	1	2	419	1076
Dcitr06g11840.1.1	588	15	603	Q7JWF1_DROME	594	10	604	0.0	71.644	98	83.05	3	8	887	2292
Dcitr06g12670.1.1	150	1	151	UBCD6_DROME	150	1	151	2.78e-111	97.351	99	98.68	0	0	311	797
Dcitr06g12740.1.1	150	1	151	UBCD6_DROME	150	1	151	2.78e-111	97.351	99	98.68	0	0	311	797
Dcitr06g13090.1.1	108	3	111	STIM_DROME	108	124	232	1.45e-51	71.560	92	81.65	0	0	170	430
Dcitr06g13240.1.1	517	1	518	KCC2A_DROME	519	1	520	0.0	87.692	99	95.77	2	2	974	2518
Dcitr06g13250.1.1	116	2	118	KCC2A_DROME	116	22	138	2.02e-76	93.162	97	97.44	0	0	234	597
Dcitr06g13340.1.1	226	133	359	Q9VCT9_DROME	226	196	422	1.88e-129	78.414	95	86.78	0	0	377	969
Dcitr06g13340.1.1	145	1	146	Q9VCT9_DROME	145	1	146	8.07e-78	79.452	95	87.67	0	0	245	625
Dcitr06g13410.1.1	16	1150	1166	KIBRA_DROME	16	1272	1288	3.4	70.588	84	82.35	0	0	31.2	69
Dcitr06g13800.1.1	184	6	190	Q9VU15_DROME	184	24	208	1.39e-122	87.568	80	92.97	0	0	348	892
Dcitr06g13840.1.1	216	1	217	Q9VU15_DROME	217	1	218	6.02e-142	86.697	88	92.66	1	1	397	1021
Dcitr06g13850.1.1	495	11	506	Q9VWP1_DROME	474	14	488	0.0	71.486	95	80.92	5	25	733	1893
Dcitr06g14430.1.1	184	18	202	MA1A1_DROME	183	474	657	6.87e-96	70.270	86	85.41	1	1	292	748
Dcitr06g14500.1.1	76	17	93	MA1A1_DROME	76	581	657	2.01e-39	77.922	73	92.21	0	0	137	346
Dcitr06g15350.1.1	186	12	198	PPIA_DROME	186	41	227	2.80e-109	81.579	94	85.79	3	6	311	797
Dcitr06g15370.1.1	186	12	198	PPIA_DROME	186	41	227	2.80e-109	81.579	94	85.79	3	6	311	797
Dcitr06g15400.1.1	294	28	322	Q9W4H6_DROME	295	32	327	8.28e-168	74.747	89	86.20	3	3	472	1214
Dcitr06g15400.1.1	294	28	322	Q7KVX1_DROME	295	76	371	1.08e-166	74.747	89	86.20	3	3	471	1211
Dcitr06g15400.1.1	255	67	322	Q7YU05_DROME	255	1	256	4.13e-150	77.821	77	87.94	2	2	424	1091
Dcitr06g15640.1.1	22	201	223	PANG2_DROME	22	1062	1084	9.83e-05	73.913	81	86.96	0	0	42.7	99
Dcitr06g15640.1.1	22	201	223	PANG1_DROME	22	621	643	1.29e-04	73.913	81	86.96	0	0	42.4	98
Dcitr06g15640.1.2	22	171	193	PANG2_DROME	22	1062	1084	7.01e-05	73.913	78	86.96	0	0	42.7	99
Dcitr06g15640.1.2	22	171	193	PANG1_DROME	22	621	643	9.49e-05	73.913	78	86.96	0	0	42.4	98
Dcitr06g15670.1.1	22	148	170	PANG2_DROME	22	1062	1084	6.00e-05	73.913	75	86.96	0	0	42.4	98
Dcitr06g15670.1.1	22	148	170	PANG1_DROME	22	621	643	8.29e-05	73.913	75	86.96	0	0	42.0	97
Dcitr07g01060.1.1	1175	1	1176	MYSN_DROME	1278	160	1438	0.0	70.781	99	81.25	5	105	1764	4570
Dcitr07g01080.1.1	172	21	193	MYSN_DROME	172	304	476	5.28e-102	85.549	88	96.53	0	0	322	824
Dcitr07g01080.1.2	238	21	259	MYSN_DROME	238	304	542	1.12e-146	87.029	89	97.49	0	0	452	1162
Dcitr07g01130.1.2	373	1	374	Q9VZ45_DROME	373	98	471	7.39e-170	70.185	95	81.53	5	10	526	1354
Dcitr07g01130.1.2	373	1	374	Q0KHU0_DROME	373	189	562	7.55e-170	70.185	95	81.53	5	10	526	1354
Dcitr07g01320.1.1	509	1	510	Q9VE18_DROME	508	1	509	0.0	81.373	99	91.37	1	1	894	2310
Dcitr07g01340.1.1	219	1	220	NUBP2_DROME	219	1	220	4.65e-120	72.273	90	85.00	0	0	342	876
Dcitr07g01670.1.1	749	521	1270	Q8IML3_DROME	796	40	836	0.0	70.375	99	79.50	8	53	1131	2926
Dcitr07g01670.1.1	519	1	520	Q8IML3_DROME	574	1	575	0.0	74.087	99	81.57	3	55	874	2259
Dcitr07g01670.1.1	519	1	520	Q6NLA3_DROME	588	1	589	0.0	72.326	99	79.63	4	69	863	2231
Dcitr07g01670.1.1	519	1	520	Q8IML4_DROME	588	1	589	0.0	72.326	99	79.63	4	69	864	2232
Dcitr07g02190.1.1	303	1	304	PELO_DROME	317	1	318	1.52e-167	71.787	99	85.27	2	16	479	1233
Dcitr07g02190.1.1	224	306	530	PELO_DROME	223	1	224	8.25e-127	76.889	99	90.67	1	1	375	964
Dcitr07g02220.1.1	263	2	265	PELO_DROME	263	65	328	4.44e-148	73.106	99	88.64	0	0	419	1076
Dcitr07g02370.1.1	358	1	359	ACT1_DROME	375	1	376	0.0	95.213	99	95.48	1	17	739	1907
Dcitr07g02370.1.1	358	1	359	ACT2_DROME	375	1	376	0.0	94.947	99	95.48	1	17	738	1905
Dcitr07g02370.1.1	358	1	359	ACT5_DROME	375	1	376	0.0	92.287	99	94.41	1	17	723	1866
Dcitr07g02580.1.1	191	1	192	RAC1_DROME	191	1	192	1.88e-130	91.146	99	94.27	0	0	363	932
Dcitr07g02580.1.1	191	1	192	RAC2_DROME	191	1	192	1.10e-129	90.104	99	93.75	0	0	361	927
Dcitr07g02610.1.1	133	8	141	RAC1_DROME	133	59	192	1.12e-84	88.060	94	92.54	0	0	245	626
Dcitr07g02610.1.1	133	8	141	RAC2_DROME	133	59	192	1.25e-83	86.567	94	91.79	0	0	243	619
Dcitr07g02810.1.1	188	43	231	A0A0B4KH88_DROME	200	46	246	3.48e-97	74.627	87	85.57	2	12	309	791
Dcitr07g02810.1.1	116	227	343	A0A0B4KH88_DROME	118	26	144	8.97e-60	84.034	87	93.28	1	2	206	525
Dcitr07g02810.1.1	188	43	231	CL16A_DROME	200	46	246	6.80e-97	74.627	87	85.57	2	12	309	791
Dcitr07g02810.1.1	116	227	343	CL16A_DROME	118	26	144	1.09e-59	84.034	87	93.28	1	2	206	525
Dcitr07g02820.1.1	109	1	110	CL16A_DROME	109	186	295	1.90e-43	70.909	74	87.27	0	0	170	431
Dcitr07g02820.1.1	109	1	110	A0A0B4KH88_DROME	109	186	295	1.93e-43	70.909	74	87.27	0	0	170	431
Dcitr07g02930.1.1	158	1	159	Q9VVI1_DROME	158	59	217	5.50e-88	79.874	72	88.05	0	0	265	677
Dcitr07g03000.1.1	189	1	190	Q9VVI1_DROME	189	59	248	5.44e-101	75.789	73	84.74	0	0	300	768
Dcitr07g03030.1.1	189	1	190	Q9VVI1_DROME	189	59	248	5.44e-101	75.789	73	84.74	0	0	300	768
Dcitr07g03710.1.1	761	24	785	Q9VIE8_DROME	759	27	786	0.0	78.637	97	87.42	3	4	1226	3171
Dcitr07g03710.1.1	762	24	786	Q8T4D6_DROME	760	17	777	0.0	74.738	97	84.55	4	4	1158	2996
Dcitr07g03720.1.1	404	147	551	Q9VIE8_DROME	404	341	745	0.0	79.506	72	88.40	0	0	690	1780
Dcitr07g03720.1.1	404	147	551	Q8T4D6_DROME	404	331	735	0.0	76.049	72	85.68	0	0	654	1687
Dcitr07g03740.1.1	91	1	92	Q9VIE8_DROME	91	401	492	1.73e-53	85.870	94	94.57	0	0	177	448
Dcitr07g03740.1.1	91	1	92	Q8T4D6_DROME	91	391	482	3.41e-50	83.696	94	88.04	0	0	167	424
Dcitr07g03850.1.1	185	1	186	U2AF2_DROME	188	228	416	2.22e-99	74.074	99	84.13	1	3	292	748
Dcitr07g03860.1.1	244	59	303	U2AF2_DROME	241	37	278	4.08e-138	78.629	84	86.29	3	9	408	1048
Dcitr07g04590.1.1	169	1	170	O18335_DROME	169	1	170	1.23e-118	95.882	81	97.06	0	0	335	859
Dcitr07g04590.1.1	169	1	170	Q8IGH2_DROME	169	1	170	9.54e-118	95.294	81	96.47	0	0	333	853
Dcitr07g04650.1.1	296	298	594	F3YDF1_DROME	296	443	739	2.25e-160	75.421	78	87.88	0	0	476	1225
Dcitr07g04650.1.1	296	298	594	A0A0B4KFY4_DROME	296	442	738	2.51e-160	75.421	78	87.88	0	0	476	1224
Dcitr07g04650.1.1	296	298	594	Q9W1Y0_DROME	296	439	735	2.88e-160	75.421	78	87.88	0	0	476	1224
Dcitr07g04850.1.1	95	11	106	SCR_DROME	100	317	417	7.51e-56	81.731	90	85.58	2	11	177	450
Dcitr07g04850.1.1	75	4	79	DFD_DROME	75	352	427	1.36e-33	71.053	71	84.21	0	0	121	303
Dcitr07g04860.1.1	95	11	106	SCR_DROME	100	317	417	7.51e-56	81.731	90	85.58	2	11	177	450
Dcitr07g04860.1.1	75	4	79	DFD_DROME	75	352	427	1.36e-33	71.053	71	84.21	0	0	121	303
Dcitr07g04880.1.1	95	11	106	SCR_DROME	100	317	417	7.51e-56	81.731	90	85.58	2	11	177	450
Dcitr07g04880.1.1	75	4	79	DFD_DROME	75	352	427	1.36e-33	71.053	71	84.21	0	0	121	303
Dcitr07g05330.1.1	411	5	416	RDX_DROME	398	431	829	0.0	79.469	99	86.47	3	17	647	1669
Dcitr07g05500.1.1	303	1	304	GPDA_DROME	316	1	317	1.82e-166	75.394	95	84.86	1	13	466	1200
Dcitr07g05510.1.1	59	23	82	SEM1_DROME	58	21	79	1.38e-12	71.667	71	85.00	1	1	57.0	136
Dcitr07g06330.1.1	182	1	183	FER_DROME	182	1135	1317	3.11e-99	75.956	97	87.43	0	0	311	797
Dcitr07g06340.1.1	334	253	587	FER_DROME	333	942	1275	0.0	78.507	80	88.96	1	1	573	1477
Dcitr07g06350.1.1	344	581	925	FER_DROME	346	929	1275	0.0	75.793	94	87.61	2	2	576	1484
Dcitr07g06420.1.1	332	21	353	Q9W2E7_DROME	331	13	344	0.0	72.372	93	82.88	1	1	528	1360
Dcitr07g06420.1.1	332	21	353	Q7JVX4_DROME	331	27	358	0.0	72.372	93	82.88	1	1	528	1360
Dcitr07g06840.1.1	435	96	531	Q9VK85_DROME	438	146	584	0.0	76.351	86	86.94	2	13	714	1843
Dcitr07g06840.1.1	136	532	668	Q9VK85_DROME	136	462	598	8.40e-70	78.832	86	91.97	0	0	238	608
Dcitr07g06840.1.1	15	23	38	Q9VK85_DROME	15	10	25	0.30	93.750	86	93.75	0	0	33.9	76
Dcitr07g06840.1.1	435	96	531	M9PD08_DROME	438	22	460	0.0	76.351	84	86.94	2	13	711	1834
Dcitr07g06840.1.1	136	532	668	M9PD08_DROME	136	338	474	1.43e-70	78.832	84	91.97	0	0	237	605
Dcitr07g06840.1.1	435	96	531	P91944_DROME	438	146	584	0.0	75.676	86	86.26	2	13	706	1823
Dcitr07g06840.1.1	136	532	668	P91944_DROME	136	462	598	9.80e-70	78.832	86	91.97	0	0	238	607
Dcitr07g06840.1.1	15	23	38	P91944_DROME	15	10	25	0.30	93.750	86	93.75	0	0	33.9	76
Dcitr07g06920.1.1	121	1	122	VATF1_DROME	121	1	122	9.51e-75	81.148	98	95.08	0	0	217	552
Dcitr07g07100.1.1	162	25	187	MESD_DROME	160	19	179	3.69e-72	73.620	77	86.50	2	2	216	550
Dcitr07g07110.1.1	162	25	187	MESD_DROME	160	19	179	3.69e-72	73.620	77	86.50	2	2	216	550
Dcitr07g07350.1.1	375	1	376	M9PFD4_DROME	387	359	746	0.0	79.028	99	87.21	6	18	654	1686
Dcitr07g07350.1.1	375	1	376	X2JCG3_DROME	371	391	762	0.0	80.260	99	88.31	6	22	653	1685
Dcitr07g07350.1.1	375	1	376	M9NFY2_DROME	388	366	754	0.0	78.880	99	87.28	7	21	652	1682
Dcitr07g07360.1.1	145	1	146	M9PFD7_DROME	152	602	754	5.94e-89	81.935	98	88.39	4	11	273	699
Dcitr07g07360.1.1	145	1	146	Q9VUV2_DROME	153	584	737	1.03e-87	81.410	98	87.82	5	12	270	689
Dcitr07g07360.1.1	145	1	146	X2JCG3_DROME	153	609	762	2.23e-87	81.410	98	87.82	5	12	269	688
Dcitr07g07380.1.1	179	54	233	CEG1A_DROME	179	126	305	2.78e-92	76.667	76	89.44	0	0	311	798
Dcitr07g07740.1.1	973	12	985	Q9VZV2_DROME	1004	8	1012	0.0	70.168	98	82.06	8	39	1480	3831
Dcitr07g07950.1.1	71	1	72	GBGE_DROME	71	1	72	7.60e-41	83.333	99	90.28	0	0	127	319
Dcitr07g08240.1.1	63	1	64	B7Z0X1_DROME	63	124	187	4.96e-32	79.688	86	93.75	0	0	114	285
Dcitr07g08240.1.1	63	1	64	Q9W457_DROME	63	194	257	7.13e-32	79.688	86	93.75	0	0	114	285
Dcitr07g08390.1.1	475	1	476	Q9VQL1_DROME	472	1	473	0.0	70.084	97	83.05	4	7	693	1789
Dcitr07g08480.1.1	641	1	642	RIR1_DROME	643	169	812	0.0	71.163	99	84.96	2	4	1006	2600
Dcitr07g08520.1.1	799	10	809	RIR1_DROME	801	11	812	0.0	71.233	99	85.31	2	4	1248	3228
Dcitr07g08800.1.1	109	4	113	RBX1A_DROME	107	1	108	5.59e-70	89.091	96	95.45	2	2	204	518
Dcitr07g08810.1.1	231	165	396	TIP60_DROME	229	225	454	1.38e-133	78.879	77	87.50	1	2	393	1009
Dcitr07g09070.1.1	169	1	170	CANB2_DROME	169	1	170	2.96e-112	91.176	99	96.47	0	0	315	808
Dcitr07g09070.1.1	169	1	170	CANB1_DROME	169	1	170	7.37e-112	90.588	99	96.47	0	0	314	805
Dcitr07g09110.1.1	169	1	170	CANB2_DROME	169	1	170	2.96e-112	91.176	99	96.47	0	0	315	808
Dcitr07g09110.1.1	169	1	170	CANB1_DROME	169	1	170	7.37e-112	90.588	99	96.47	0	0	314	805
Dcitr07g09810.1.1	386	10	396	Q9V9Q6_DROME	387	23	410	0.0	80.670	97	88.66	1	1	659	1699
Dcitr07g09810.1.1	386	10	396	Q0E8N2_DROME	380	347	727	0.0	77.062	97	85.05	2	8	626	1615
Dcitr07g09820.1.1	194	34	228	Q9V9Q6_DROME	194	76	270	8.26e-118	83.077	79	91.79	0	0	342	876
Dcitr07g09820.1.1	194	34	228	Q0E8N2_DROME	194	393	587	2.13e-114	83.077	79	91.79	0	0	343	880
Dcitr07g09850.1.1	142	11	153	Q9V9Q6_DROME	143	267	410	2.38e-86	83.333	92	86.81	1	1	258	658
Dcitr07g09850.1.1	142	11	153	Q0E8N2_DROME	143	584	727	9.11e-84	83.333	92	86.81	1	1	259	663
Dcitr07g09920.1.1	317	71	388	Q7KPX5_DROME	320	100	420	2.27e-176	73.520	81	84.74	2	3	497	1280
Dcitr07g09920.1.1	317	71	388	Q7KPK6_DROME	320	100	420	2.39e-176	73.520	81	84.74	2	3	497	1279
Dcitr07g09920.1.1	317	71	388	O61444_DROME	320	100	420	1.09e-175	73.209	81	84.42	2	3	495	1275
Dcitr07g09940.1.1	143	1	144	O97454_DROME	143	1	144	1.72e-95	90.278	99	93.75	0	0	271	692
Dcitr07g09970.1.1	216	1	217	O61444_DROME	222	198	420	5.16e-118	73.094	98	84.75	2	6	342	876
Dcitr07g09970.1.1	216	1	217	Q7KPX5_DROME	222	198	420	5.45e-118	73.094	98	84.75	2	6	342	876
Dcitr07g09970.1.1	216	1	217	Q7KPK6_DROME	222	198	420	6.42e-118	73.094	98	84.75	2	6	341	875
Dcitr07g09980.1.1	143	1	144	O97454_DROME	143	1	144	1.72e-95	90.278	99	93.75	0	0	271	692
Dcitr07g10400.1.1	196	14	210	UBA3_DROME	199	14	213	2.75e-109	73.500	71	87.00	1	3	323	827
Dcitr07g10700.1.1	72	290	362	A0A0B4KEW6_DROME	72	430	502	2.39e-32	72.603	97	84.93	0	0	126	316
Dcitr07g10700.1.1	72	290	362	Q7KLE5_DROME	72	530	602	4.75e-32	72.603	97	84.93	0	0	126	316
Dcitr07g10700.1.3	72	355	427	Q7KLE5_DROME	72	530	602	3.29e-31	72.603	97	84.93	0	0	125	313
Dcitr07g11010.1.1	210	1	211	DRK_DROME	210	1	211	5.18e-147	90.047	99	96.21	0	0	407	1045
Dcitr07g11040.1.1	210	1	211	DRK_DROME	210	1	211	5.18e-147	90.047	99	96.21	0	0	407	1045
Dcitr07g11180.1.1	531	5	536	MCM6_DROME	534	4	538	0.0	73.507	99	85.82	2	5	840	2170
Dcitr07g11200.1.1	641	5	646	MCM6_DROME	624	4	628	0.0	70.872	94	83.80	2	17	965	2495
Dcitr07g11440.1.1	112	548	660	SPTCA_DROME	112	1	113	2.70e-50	83.186	98	90.27	0	0	189	481
Dcitr07g11450.1.1	224	145	369	Q9W433_DROME	218	1208	1426	1.28e-107	76.889	80	84.89	3	6	346	887
Dcitr07g11450.1.1	224	145	369	M9NGR9_DROME	218	1200	1418	1.37e-107	76.889	80	84.89	3	6	346	887
Dcitr07g11470.1.1	687	1	688	SPTCA_DROME	687	1728	2415	0.0	85.029	99	92.73	0	0	1233	3190
Dcitr07g11480.1.1	2413	4	2417	SPTCA_DROME	2414	1	2415	0.0	82.112	99	90.85	1	1	4096	10622
Dcitr07g11560.1.1	202	10	212	M9NDQ0_DROME	201	339	540	1.64e-86	71.921	98	81.28	1	1	278	711
Dcitr07g11560.1.1	202	10	212	A8JUY8_DROME	201	339	540	1.64e-86	71.921	98	81.28	1	1	278	711
Dcitr07g11560.1.1	202	10	212	M9NGR9_DROME	201	339	540	1.73e-86	71.921	98	81.28	1	1	278	711
Dcitr07g11580.1.1	270	13	283	M9NGR9_DROME	269	417	686	3.30e-124	76.384	73	86.35	1	1	409	1051
Dcitr07g11580.1.1	170	523	693	M9NGR9_DROME	167	1200	1367	1.75e-70	73.684	73	83.04	1	3	251	642
Dcitr07g11580.1.1	270	13	283	A8JUY8_DROME	269	417	686	3.64e-124	76.384	83	86.35	1	1	409	1051
Dcitr07g11580.1.1	170	523	693	A8JUY8_DROME	167	1208	1375	1.78e-70	73.684	83	83.04	1	3	251	642
Dcitr07g11580.1.1	270	13	283	Q9W433_DROME	269	417	686	3.96e-124	76.384	73	86.35	1	1	409	1051
Dcitr07g11580.1.1	170	523	693	Q9W433_DROME	167	1208	1375	2.14e-70	73.684	73	83.04	1	3	251	641
Dcitr07g11590.1.1	100	1	101	M9NGR9_DROME	100	497	597	3.26e-55	74.257	100	82.18	0	0	183	464
Dcitr07g11590.1.1	100	1	101	Q9W433_DROME	100	497	597	3.26e-55	74.257	100	82.18	0	0	183	464
Dcitr07g11590.1.1	100	1	101	M9NDQ0_DROME	100	497	597	3.26e-55	74.257	100	82.18	0	0	183	464
Dcitr07g11920.1.1	529	7	536	EIF3D_NASVI	518	19	537	0.0	75.610	96	84.43	7	17	820	2119
Dcitr07g12030.1.1	211	1	212	ERD2_DROME	211	1	212	4.21e-127	79.717	99	90.09	0	0	356	914
Dcitr07g12040.1.1	208	1	209	ERD2_DROME	211	1	212	1.03e-122	78.302	99	88.68	1	3	345	885
Dcitr07g12160.1.1	131	10	141	Q6NN09_DROME	128	10	138	5.70e-61	73.881	93	84.33	3	7	183	465
Dcitr07g12680.1.1	313	1	314	Q9V9Z3_DROME	315	121	436	0.0	73.418	99	88.92	1	2	508	1308
Dcitr07g12680.1.1	244	70	314	Q8SY08_DROME	244	1	245	1.34e-151	77.959	78	91.84	0	0	424	1090
Dcitr08g01100.1.2	574	1	575	NMDA1_DROME	570	346	916	0.0	75.302	95	85.15	6	12	879	2271
Dcitr08g01100.1.3	574	1	575	NMDA1_DROME	570	346	916	0.0	75.130	95	84.97	6	12	876	2263
Dcitr08g01170.1.1	753	18	771	CAPS_DROME	742	168	910	0.0	73.168	95	84.82	6	31	1173	3035
Dcitr08g01320.1.1	351	1	352	KAPC_DROME	352	1	353	0.0	94.051	99	97.73	1	1	696	1797
Dcitr08g01610.1.1	1174	22	1196	Q0E9E2_DROME	1173	24	1197	0.0	82.398	98	91.16	2	3	2005	5195
Dcitr08g01610.1.1	1174	22	1196	Q7KN97_DROME	1157	24	1181	0.0	82.128	98	90.64	1	17	1998	5176
Dcitr08g01740.1.1	299	8	307	Q9VGF7_DROME	298	21	319	7.89e-149	71.667	97	82.67	1	1	420	1079
Dcitr08g01960.1.1	215	181	396	Q9U3Z9_DROME	213	294	507	7.60e-94	75.463	72	84.72	1	2	305	782
Dcitr08g01960.1.1	215	181	396	Q9VPU7_DROME	213	294	507	7.60e-94	75.463	72	84.72	1	2	305	782
Dcitr08g01960.1.1	215	181	396	Q8IPW1_DROME	213	321	534	1.96e-93	75.463	72	84.72	1	2	305	781
Dcitr08g02100.1.1	509	1	510	A5XCL5_DROME	510	1	511	0.0	70.623	99	85.99	4	7	761	1966
Dcitr08g02100.1.1	503	7	510	E1JI91_DROME	506	12	518	0.0	71.063	99	86.42	3	5	761	1965
Dcitr08g02100.1.1	503	7	510	Q9VSW1_DROME	508	12	520	0.0	70.784	99	86.08	4	7	756	1952
Dcitr08g02320.1.1	107	1	108	A0A0B4KGP1_DROME	107	54	161	4.93e-66	83.333	78	94.44	0	0	216	549
Dcitr08g02320.1.1	107	1	108	Q7YU77_DROME	107	54	161	6.49e-66	83.333	78	94.44	0	0	215	548
Dcitr08g02320.1.1	107	1	108	Q9VI63_DROME	107	54	161	6.49e-66	83.333	78	94.44	0	0	215	548
Dcitr08g02330.1.1	248	19	267	OPTIX_DROME	246	24	270	1.69e-111	70.635	89	81.75	2	8	330	845
Dcitr08g02340.1.1	248	15	263	OPTIX_DROME	246	24	270	2.36e-111	70.635	90	81.75	2	8	329	844
Dcitr08g02650.1.1	374	23	397	A1Z9M6_DROME	375	170	545	0.0	76.064	94	89.10	1	1	609	1571
Dcitr08g02980.1.1	843	1	844	PIPA_DROME	853	1	854	0.0	70.983	98	81.39	4	32	1263	3267
Dcitr08g02980.1.2	843	1	844	PIPA_DROME	853	1	854	0.0	70.520	98	80.81	4	32	1249	3232
Dcitr08g03210.1.1	398	1	399	Q9VUV4_DROME	402	1	403	0.0	79.653	72	89.33	2	4	684	1766
Dcitr08g03210.1.1	398	1	399	M9PFS3_DROME	402	1	403	0.0	79.653	72	89.33	2	4	684	1766
Dcitr08g03210.1.1	398	1	399	M9PFM1_DROME	402	1	403	0.0	79.653	72	89.33	2	4	684	1765
Dcitr08g03500.1.1	183	1	184	SIF1_DROME	183	1620	1803	4.18e-120	95.109	90	98.91	0	0	374	959
Dcitr08g03500.1.1	183	1	184	SIF2_DROME	183	1609	1792	4.48e-120	95.109	90	98.91	0	0	374	959
Dcitr08g03500.1.2	186	1	187	SIF1_DROME	183	1620	1803	3.74e-118	93.583	90	97.33	1	3	368	945
Dcitr08g03500.1.2	186	1	187	SIF2_DROME	183	1609	1792	4.17e-118	93.583	90	97.33	1	3	368	945
Dcitr08g03540.1.1	82	1794	1876	SIF1_DROME	84	1978	2062	4.87e-22	72.941	98	80.00	1	2	103	258
Dcitr08g03680.1.1	427	20	447	A1ZBL0_DROME	427	29	456	0.0	98.832	96	99.53	0	0	892	2306
Dcitr08g03680.1.1	429	1	430	TBB2_DROME	429	1	430	0.0	96.047	96	98.14	0	0	848	2190
Dcitr08g03680.1.1	442	1	443	TBB3_DROME	446	1	447	0.0	90.646	99	95.55	2	8	830	2144
Dcitr08g03720.1.1	178	1	179	Q9VSG8_DROME	178	1	179	2.59e-112	79.888	99	92.18	0	0	316	810
Dcitr08g04200.1.1	339	11	350	Q8IGJ4_DROME	340	13	353	0.0	73.900	96	85.92	1	1	536	1380
Dcitr08g04200.1.1	339	11	350	Q7K5K3_DROME	340	13	353	0.0	73.900	96	85.92	1	1	535	1379
Dcitr08g04260.1.1	620	2	622	Q9VHN7_DROME	620	5	625	0.0	74.235	99	85.02	0	0	972	2512
Dcitr08g04260.1.1	578	44	622	Q7KSU6_DROME	578	1	579	0.0	74.439	93	85.15	0	0	914	2362
Dcitr08g04260.1.2	624	1	625	Q9VHN7_DROME	624	1	625	0.0	74.560	99	85.12	0	0	983	2541
Dcitr08g04260.1.2	578	47	625	Q7KSU6_DROME	578	1	579	0.0	74.439	92	85.15	0	0	913	2360
Dcitr08g04300.1.1	521	2	523	A1Z784_DROME	522	1540	2062	0.0	73.231	92	86.23	1	1	817	2111
Dcitr08g04300.1.1	521	2	523	A8DY67_DROME	522	1406	1928	0.0	73.231	92	86.23	1	1	816	2109
Dcitr08g04300.1.1	521	2	523	Q7JV23_DROME	522	1381	1903	0.0	73.231	92	86.23	1	1	816	2108
Dcitr08g04330.1.1	1335	1	1336	A1Z784_DROME	1336	834	2170	0.0	73.174	99	85.92	7	11	2061	5339
Dcitr08g04330.1.1	1335	1	1336	Q7JV23_DROME	1336	675	2011	0.0	73.174	99	85.92	7	11	2060	5338
Dcitr08g04330.1.1	1335	1	1336	A8DY67_DROME	1336	700	2036	0.0	73.174	99	85.92	7	11	2058	5333
Dcitr08g04580.1.1	395	9	404	ARRB_DROME	394	1	395	0.0	70.960	97	85.35	1	1	593	1528
Dcitr08g05050.1.1	847	27	874	CAC1D_DROME	838	581	1419	0.0	71.328	99	79.79	6	15	1196	3093
Dcitr08g05060.1.1	329	6	335	CAC1D_DROME	329	1301	1630	1.89e-167	79.394	99	88.48	0	0	515	1327
Dcitr08g05240.1.1	490	1	491	DCE_DROME	489	21	510	0.0	73.780	99	86.18	2	3	785	2028
Dcitr08g05250.1.1	376	58	434	SULF1_DROME	374	50	424	0.0	76.393	85	89.12	1	2	647	1669
Dcitr08g05250.1.2	376	58	434	SULF1_DROME	374	50	424	0.0	76.393	85	89.12	1	2	647	1669
Dcitr08g05280.1.1	413	14	427	Q9BMD4_DROME	415	11	426	0.0	74.760	84	88.22	1	2	676	1745
Dcitr08g05280.1.1	413	14	427	A1Z8J3_DROME	415	11	426	0.0	74.760	84	88.22	1	2	676	1745
Dcitr08g05280.1.1	413	14	427	Q9BMD5_DROME	415	11	426	0.0	74.760	84	88.22	1	2	676	1744
Dcitr08g05390.1.1	456	21	477	GBRB3_DROME	464	29	493	0.0	70.600	95	79.30	8	44	660	1702
Dcitr08g05470.1.1	198	1	199	Q5CCJ5_BOMMO	199	1	200	3.34e-104	76.500	99	89.00	1	1	297	761
Dcitr08g05470.1.1	187	12	199	RAS2_DROME	188	4	192	1.06e-101	79.365	94	88.89	1	1	291	744
Dcitr08g05730.1.1	187	50	237	Q1HQ70_BOMMO	187	1	188	7.76e-121	85.106	79	92.55	0	0	341	874
Dcitr08g05730.1.1	187	50	237	Q9VZI1_DROME	187	1	188	2.76e-110	78.723	79	88.30	0	0	314	804
Dcitr08g05730.1.1	172	65	237	M9PE30_DROME	172	3	175	4.53e-99	77.457	73	87.28	0	0	285	729
Dcitr08g05940.1.1	201	1	202	PUR1_DROME	207	339	546	6.14e-111	76.442	99	86.54	2	6	327	838
Dcitr08g05970.1.1	310	5	315	PPP6_DROME	299	4	303	3.02e-176	73.955	98	83.92	1	11	489	1258
Dcitr08g06050.1.1	578	34	612	Q9V4E7_DROME	577	53	630	0.0	72.193	94	86.01	1	1	908	2347
Dcitr08g06050.1.1	450	34	484	Q8IMC1_DROME	447	53	500	0.0	73.836	73	86.70	2	3	708	1828
Dcitr08g06100.1.1	268	1	269	A1Z9K8_DROME	268	99	367	4.50e-134	72.119	85	87.73	0	0	436	1120
Dcitr08g06140.1.1	681	17	698	Q8MS37_DROME	697	18	715	0.0	75.178	98	86.31	6	22	1123	2906
Dcitr08g06260.1.1	51	12	63	Q7KV69_DROME	51	49	100	4.69e-19	84.615	99	92.31	0	0	95.5	236
Dcitr08g06260.1.1	51	12	63	Q7KV70_DROME	51	49	100	4.82e-19	84.615	99	92.31	0	0	95.5	236
Dcitr08g06260.1.1	51	12	63	Q9VZQ3_DROME	51	49	100	4.80e-19	84.615	99	92.31	0	0	95.5	236
Dcitr08g06390.1.1	155	1	156	CANB2_DROME	155	1	156	6.30e-104	92.949	91	96.79	0	0	294	753
Dcitr08g06390.1.1	155	1	156	CANB1_DROME	155	1	156	1.42e-103	92.308	91	96.79	0	0	293	751
Dcitr08g06410.1.1	77	16	93	CANB1_DROME	77	79	156	2.49e-46	91.026	72	96.15	0	0	146	368
Dcitr08g06410.1.1	77	16	93	CANB2_DROME	77	79	156	2.78e-46	92.308	72	96.15	0	0	145	367
Dcitr08g06590.1.1	178	1	179	ARL1_DROME	178	1	179	1.63e-114	86.034	99	92.18	0	0	322	825
Dcitr08g06650.1.1	158	1	159	Q9V4E1_DROME	155	228	383	5.03e-84	78.616	83	86.79	2	3	262	669
Dcitr08g07390.1.1	374	1	375	CAC1A_DROME	371	1	372	0.0	74.133	100	82.40	1	3	563	1450
Dcitr08g07420.1.1	186	10	196	CAC1A_DROME	185	1185	1370	1.02e-103	85.638	95	89.36	2	3	326	836
Dcitr08g07450.1.1	259	10	269	Q9VNL0_DROME	252	5	257	2.31e-148	76.923	86	84.62	2	7	416	1069
Dcitr08g07450.1.1	227	10	237	A8JQU3_DROME	227	5	232	1.39e-139	79.386	75	88.16	0	0	393	1009
Dcitr08g07470.1.1	539	1	540	KCNAL_DROME	539	1	540	0.0	94.444	85	97.78	0	0	1065	2754
Dcitr08g07470.1.2	539	1	540	KCNAL_DROME	539	1	540	0.0	94.444	99	97.78	0	0	1059	2738
Dcitr08g07550.1.1	70	7	77	Q59DQ0_DROME	73	1110	1183	3.61e-36	86.486	91	91.89	1	3	127	319
Dcitr08g07550.1.1	69	8	77	E6EK17_DROME	72	1115	1187	4.39e-36	87.671	90	91.78	1	3	127	319
Dcitr08g07550.1.1	69	8	77	E6EK18_DROME	72	1138	1210	4.47e-36	87.671	90	91.78	1	3	127	318
Dcitr08g07560.1.1	1106	1	1107	E6EK15_DROME	1122	1	1123	0.0	81.851	99	88.70	4	18	1880	4870
Dcitr08g07560.1.1	1106	1	1107	Q9V4C7_DROME	1134	1	1135	0.0	81.074	99	88.03	5	30	1876	4860
Dcitr08g07560.1.1	1106	1	1107	E6EK18_DROME	1138	1	1139	0.0	80.789	99	87.72	6	34	1871	4847
Dcitr08g07560.1.2	1093	1	1094	E6EK18_DROME	1109	1	1110	0.0	80.918	99	88.39	4	18	1842	4772
Dcitr08g07560.1.2	1095	1	1096	Q59DQ0_DROME	1111	1	1112	0.0	80.863	99	88.32	4	18	1842	4772
Dcitr08g07560.1.2	1093	1	1094	E6EK17_DROME	1109	1	1110	0.0	80.918	99	88.39	4	18	1842	4771
Dcitr08g07560.1.3	1106	1	1107	E6EK15_DROME	1122	1	1123	0.0	81.851	99	88.70	4	18	1880	4870
Dcitr08g07560.1.3	1106	1	1107	Q9V4C7_DROME	1134	1	1135	0.0	81.074	99	88.03	5	30	1876	4860
Dcitr08g07560.1.3	1106	1	1107	E6EK18_DROME	1138	1	1139	0.0	80.789	99	87.72	6	34	1871	4847
Dcitr08g07560.1.4	1093	1	1094	E6EK18_DROME	1109	1	1110	0.0	80.918	99	88.39	4	18	1842	4772
Dcitr08g07560.1.4	1095	1	1096	Q59DQ0_DROME	1111	1	1112	0.0	80.863	99	88.32	4	18	1842	4772
Dcitr08g07560.1.4	1093	1	1094	E6EK17_DROME	1109	1	1110	0.0	80.918	99	88.39	4	18	1842	4771
Dcitr08g07560.1.5	1121	1	1122	Q59DP9_DROME	1137	1	1138	0.0	80.948	95	88.41	4	18	1887	4889
Dcitr08g07560.1.5	1105	1	1106	Q59DQ0_DROME	1121	1	1122	0.0	80.499	93	88.25	4	18	1856	4807
Dcitr08g07560.1.5	1105	1	1106	E6EK17_DROME	1125	1	1126	0.0	80.213	93	87.93	5	22	1850	4791
Dcitr08g07750.1.1	253	42	295	SINA_DROME	253	61	314	1.07e-159	83.071	86	88.58	0	0	446	1148
Dcitr08g07780.1.1	162	1	163	U2AF1_DROME	162	1	163	2.62e-116	93.865	99	97.55	0	0	329	843
Dcitr08g07940.1.1	318	1	319	Q94515_DROME	318	1	319	0.0	71.787	99	86.21	0	0	513	1320
Dcitr08g07950.1.1	160	3	163	Q9VG51_DROME	161	6	167	3.32e-104	87.037	98	93.21	1	1	295	754
Dcitr08g08180.1.1	15	57	72	Q9W4B3_DROME	15	1	16	0.016	93.750	71	100.00	0	0	36.6	83
Dcitr08g08180.1.1	15	57	72	X2JDS9_DROME	15	1	16	0.016	93.750	71	100.00	0	0	36.6	83
Dcitr08g08180.1.2	15	57	72	Q9W4B3_DROME	15	1	16	0.016	93.750	71	100.00	0	0	36.6	83
Dcitr08g08180.1.2	15	57	72	X2JDS9_DROME	15	1	16	0.016	93.750	71	100.00	0	0	36.6	83
Dcitr08g08280.1.1	471	17	488	MNB_DROME	488	6	494	0.0	79.141	88	86.09	4	17	789	2038
Dcitr08g08280.1.2	471	17	488	MNB_DROME	488	6	494	0.0	79.141	75	86.09	4	17	788	2036
Dcitr08g08280.1.2	14	636	650	MNB_DROME	14	894	908	1.9	80.000	75	86.67	0	0	31.2	69
Dcitr08g08280.1.3	471	17	488	MNB_DROME	488	6	494	0.0	79.141	88	86.09	4	17	789	2038
Dcitr08g08280.1.4	471	17	488	MNB_DROME	488	6	494	0.0	79.141	88	86.09	4	17	789	2038
Dcitr08g08280.1.5	471	17	488	MNB_DROME	488	6	494	0.0	79.141	75	86.09	4	17	788	2036
Dcitr08g08280.1.5	14	636	650	MNB_DROME	14	894	908	1.9	80.000	75	86.67	0	0	31.2	69
Dcitr08g08390.1.1	969	11	980	X2JBI1_DROME	964	578	1542	0.0	79.098	98	86.89	7	17	1601	4145
Dcitr08g08390.1.1	969	11	980	X2JF15_DROME	964	555	1519	0.0	79.098	98	86.89	7	17	1600	4144
Dcitr08g08390.1.1	969	11	980	X2JEQ0_DROME	962	578	1540	0.0	78.791	98	86.58	8	19	1588	4112
Dcitr08g08510.1.1	107	1	108	FKB12_DROME	107	1	108	1.45e-58	75.926	98	85.19	0	0	175	443
Dcitr08g08630.1.1	929	1	930	ACTN_DROME	922	2	924	0.0	91.613	99	95.59	1	7	1774	4595
Dcitr08g08630.1.1	918	12	930	ACTN_DERFA	881	4	885	0.0	80.652	99	86.96	3	39	1516	3926
Dcitr08g08700.1.1	319	1	320	GNAS_DROME	322	63	385	0.0	84.211	99	91.02	1	3	553	1426
Dcitr08g08830.1.1	358	1	359	INX1_SCHAM	358	1	359	0.0	72.702	99	86.63	0	0	581	1498
Dcitr08g08840.1.1	358	1	359	INX2_SCHAM	358	1	359	0.0	81.058	99	91.64	0	0	634	1636
Dcitr08g08840.1.1	356	1	357	INX2_DROME	356	1	357	0.0	75.910	99	90.48	0	0	605	1559
Dcitr08g09050.1.1	113	40	153	Q8SZA8_DROME	113	39	152	1.28e-58	70.175	74	85.96	0	0	178	452
Dcitr08g09090.1.1	832	7	839	DYN_DROME	827	1	828	0.0	80.502	99	88.28	6	11	1356	3509
Dcitr08g09210.1.1	88	7	95	ONEC_DROME	86	897	983	3.92e-43	79.775	79	88.76	1	2	149	375
Dcitr08g09330.1.1	171	2	173	A8Y589_DROME	171	7	178	3.93e-94	70.349	99	86.05	0	0	270	690
Dcitr08g09430.1.1	286	244	530	PAKM_DROME	286	351	637	0.0	91.289	78	95.82	0	0	555	1430
Dcitr08g09720.1.1	353	1	354	GNAI_DROME	354	1	355	0.0	79.155	99	90.42	1	1	602	1553
Dcitr08g09730.1.1	743	40	783	Q9V3Q9_DROME	760	33	793	0.0	75.591	92	85.04	2	19	1212	3136
Dcitr08g09730.1.2	743	29	772	Q9V3Q9_DROME	760	33	793	0.0	75.591	93	85.04	2	19	1211	3134
Dcitr08g09870.1.1	27	1321	1348	SICK_DROME	27	1298	1325	1.49e-04	75.000	80	85.71	0	0	46.2	108
Dcitr08g10010.1.1	16	1	17	O77291_DROME	16	1	17	8.67e-04	82.353	95	94.12	0	0	36.6	83
Dcitr08g10010.1.1	16	1	17	B7YZG5_DROME	16	1	17	8.86e-04	82.353	95	94.12	0	0	36.6	83
Dcitr08g10170.1.1	147	19	166	CALM_DROME	147	2	149	6.31e-105	100.000	89	100.00	0	0	296	757
Dcitr08g10170.1.2	148	1	149	CALM_DROME	148	1	149	7.50e-106	100.000	99	100.00	0	0	297	761
Dcitr08g10200.1.1	138	32	170	CALM_DROME	138	2	140	2.33e-98	100.000	75	100.00	0	0	280	716
Dcitr08g10350.1.1	292	99	391	EXD_DROME	300	39	339	0.0	85.099	85	91.72	3	10	509	1311
Dcitr08g10400.1.1	301	29	330	EXD_DROME	311	39	350	0.0	83.706	91	90.42	4	12	514	1324
Dcitr08g11400.1.1	123	1	124	ITPR_DROME	123	576	699	3.37e-63	89.516	98	94.35	0	0	235	600
Dcitr08g11480.1.1	372	1	373	STNB_DROME	366	880	1246	0.0	77.480	99	85.25	2	6	607	1564
Dcitr08g11540.1.1	255	1	256	Q9VDU9_DROME	254	43	297	6.29e-172	88.672	100	94.14	1	1	482	1241
Dcitr08g11540.1.1	255	1	256	A1KYB3_DROME	254	43	297	2.34e-171	88.281	100	94.14	1	1	481	1237
Dcitr08g11540.1.1	255	1	256	A1KYB5_DROME	254	43	297	2.41e-171	88.281	100	94.14	1	1	481	1237
Dcitr08g11620.1.1	116	34	150	A1KYB4_DROME	121	5	126	2.90e-60	77.049	77	79.51	1	5	192	489
Dcitr08g11620.1.1	116	34	150	Q9VDU9_DROME	121	5	126	3.03e-60	77.049	77	79.51	1	5	192	489
Dcitr08g11620.1.1	116	34	150	A1KYB3_DROME	121	5	126	3.16e-60	77.049	77	79.51	1	5	192	489
Dcitr08g11640.1.1	292	15	307	Q9VDU9_DROME	317	26	343	2.39e-165	73.354	88	79.94	4	27	471	1211
Dcitr08g11640.1.1	292	15	307	A1KYB5_DROME	317	26	343	1.02e-164	73.041	88	79.94	4	27	469	1207
Dcitr08g11640.1.1	292	15	307	A1KYB3_DROME	317	26	343	1.13e-164	73.041	88	79.94	4	27	469	1207
Dcitr08g12060.1.2	214	1	215	D1YSG0_DROME	214	1	215	3.23e-111	74.884	99	86.51	0	0	349	895
Dcitr08g12060.1.2	213	1	214	Q7KQP6_DROME	213	1	214	3.35e-111	75.234	99	86.45	0	0	349	895
Dcitr08g12060.1.2	213	1	214	X2JD89_DROME	213	1	214	3.66e-111	75.234	99	86.45	0	0	349	895
Dcitr08g12380.1.1	112	22	134	PBURS_DROME	112	29	141	4.60e-68	78.761	84	92.04	0	0	201	511
Dcitr08g12450.1.1	130	206	336	Q24279_DROME	130	5	135	6.84e-68	80.153	94	89.31	0	0	230	587
Dcitr08g12450.1.1	130	206	336	A0A0B4KGI6_DROME	130	5	135	6.68e-68	80.153	94	89.31	0	0	230	587
Dcitr08g12450.1.1	130	206	336	Q95TT5_DROME	130	5	135	7.34e-68	80.153	94	89.31	0	0	230	587
Dcitr08g12470.1.1	153	30	183	Q24279_DROME	149	1	150	5.41e-72	71.429	81	84.42	1	4	235	600
Dcitr08g12470.1.1	153	30	183	A0A0B4KGI6_DROME	149	1	150	5.86e-72	71.429	81	84.42	1	4	235	599
Dcitr08g12470.1.1	153	30	183	Q95TT5_DROME	149	1	150	6.17e-72	71.429	81	84.42	1	4	235	599
Dcitr09g01070.1.1	344	272	616	PUM_DROME	338	1092	1430	0.0	80.000	79	86.96	1	6	581	1497
Dcitr09g01190.1.1	518	11	529	PDE6_DROME	521	563	1084	0.0	71.161	90	79.40	5	27	778	2009
Dcitr09g01490.1.2	364	1	365	Q9W002_DROME	368	1	369	0.0	89.973	96	93.77	2	4	682	1761
Dcitr09g01490.1.2	364	1	365	M9PH19_DROME	368	1	369	0.0	89.973	96	93.77	2	4	682	1759
Dcitr09g01490.1.2	375	1	376	Q7KV90_DROME	376	1	377	0.0	88.158	99	92.37	3	7	678	1750
Dcitr09g01520.1.1	359	1	360	CTBP_DROME	355	1	356	0.0	90.000	71	94.72	2	4	673	1737
Dcitr09g01570.1.1	36	669	705	TRC8_DROME	36	626	662	3.13e-15	83.784	77	91.89	0	0	79.7	195
Dcitr09g01880.1.1	174	1	175	Q9VW54_DROME	174	740	914	7.52e-84	70.857	97	84.00	0	0	264	675
Dcitr09g01960.1.1	461	1	462	C6TP87_DROME	461	1	462	0.0	90.260	99	94.59	0	0	869	2245
Dcitr09g01960.1.1	360	102	462	Q8T3U3_DROME	360	1	361	0.0	88.366	78	93.35	0	0	665	1715
Dcitr09g01970.1.1	253	1	254	RL8_DROME	253	1	254	2.41e-165	87.402	98	94.88	0	0	457	1175
Dcitr09g02030.1.1	242	1	243	VATD1_DROME	245	1	246	1.60e-146	82.520	99	90.65	1	3	408	1049
Dcitr09g02100.1.1	242	1	243	VATD1_DROME	245	1	246	1.60e-146	82.520	99	90.65	1	3	408	1049
Dcitr09g02190.1.1	414	1	415	C6TP87_DROME	415	1	416	0.0	90.385	97	94.71	1	1	783	2021
Dcitr09g02190.1.1	313	102	415	Q8T3U3_DROME	314	1	315	0.0	88.254	73	93.33	1	1	578	1491
Dcitr09g02190.1.2	460	1	461	C6TP87_DROME	461	1	462	0.0	86.364	99	90.91	1	1	817	2110
Dcitr09g02190.1.2	359	102	461	Q8T3U3_DROME	360	1	361	0.0	82.065	78	87.23	2	15	614	1583
Dcitr09g02190.1.3	391	1	392	C6TP87_DROME	391	1	392	0.0	90.561	93	94.64	0	0	742	1915
Dcitr09g02200.1.1	253	1	254	RL8_DROME	253	1	254	2.41e-165	87.402	98	94.88	0	0	457	1175
Dcitr09g02410.1.1	403	114	517	Q24190_DROME	417	287	704	0.0	73.882	78	79.76	5	28	602	1551
Dcitr09g02410.1.1	403	114	517	Q9VI13_DROME	417	287	704	0.0	73.882	78	79.76	5	28	602	1551
Dcitr09g02410.1.1	403	114	517	Q24213_DROME	417	287	704	0.0	72.960	78	78.55	6	36	598	1543
Dcitr09g02410.1.2	403	105	508	Q9VI13_DROME	417	287	704	0.0	73.882	89	79.76	5	28	603	1556
Dcitr09g02410.1.2	46	1	47	Q9VI13_DROME	46	107	153	1.24e-17	82.979	89	89.36	0	0	85.5	210
Dcitr09g02410.1.2	403	105	508	Q24190_DROME	417	287	704	0.0	73.427	89	78.79	6	36	603	1555
Dcitr09g02410.1.2	46	1	47	Q24190_DROME	46	107	153	1.25e-17	82.979	89	89.36	0	0	85.5	210
Dcitr09g02410.1.2	403	105	508	Q24213_DROME	417	287	704	0.0	72.960	89	78.55	6	36	600	1548
Dcitr09g02410.1.2	46	1	47	Q24213_DROME	46	107	153	1.29e-17	82.979	89	89.36	0	0	85.5	210
Dcitr09g02410.1.3	403	105	508	Q9VI13_DROME	417	287	704	0.0	73.882	89	79.76	5	28	603	1556
Dcitr09g02410.1.3	46	1	47	Q9VI13_DROME	46	107	153	1.24e-17	82.979	89	89.36	0	0	85.5	210
Dcitr09g02410.1.3	403	105	508	Q24190_DROME	417	287	704	0.0	73.427	89	78.79	6	36	603	1555
Dcitr09g02410.1.3	46	1	47	Q24190_DROME	46	107	153	1.25e-17	82.979	89	89.36	0	0	85.5	210
Dcitr09g02410.1.3	403	105	508	Q24213_DROME	417	287	704	0.0	72.960	89	78.55	6	36	600	1548
Dcitr09g02410.1.3	46	1	47	Q24213_DROME	46	107	153	1.29e-17	82.979	89	89.36	0	0	85.5	210
Dcitr09g02510.1.1	687	20	707	Q9VRE0_DROME	697	16	713	0.0	77.857	97	88.29	3	14	1160	3002
Dcitr09g02650.1.1	370	1	371	TBA1_DROME	370	36	406	0.0	94.609	97	98.92	0	0	726	1873
Dcitr09g02650.1.1	370	1	371	TBA3_DROME	370	36	406	0.0	94.070	97	98.65	0	0	722	1863
Dcitr09g02650.1.1	370	1	371	TBA2_DROME	370	36	406	0.0	92.453	97	97.84	0	0	714	1843
Dcitr09g02670.1.1	454	1	455	RUVB1_DROME	454	1	455	0.0	82.198	99	90.99	0	0	746	1925
Dcitr09g02700.1.1	406	1	407	TBA1_DROME	406	1	407	0.0	95.086	94	99.02	0	0	806	2082
Dcitr09g02700.1.1	406	1	407	TBA3_DROME	406	1	407	0.0	94.595	94	98.77	0	0	803	2075
Dcitr09g02700.1.1	406	1	407	TBA2_DROME	406	1	407	0.0	92.383	94	97.79	0	0	792	2045
Dcitr09g02740.1.1	246	1	247	RUVB1_DROME	246	83	329	2.48e-164	88.664	84	97.17	0	0	464	1193
Dcitr09g02960.1.1	429	452	881	Q9VLC5_DROME	437	24	461	0.0	72.045	97	84.32	4	12	661	1706
Dcitr09g03020.1.1	300	47	347	Q86NP0_DROME	298	178	476	7.03e-168	76.412	86	86.38	1	2	490	1261
Dcitr09g03020.1.1	300	47	347	Q9VR61_DROME	298	178	476	1.21e-167	76.412	86	86.38	1	2	490	1261
Dcitr09g03020.1.1	300	47	347	Q24496_DROME	298	177	475	1.27e-167	76.412	86	86.38	1	2	490	1261
Dcitr09g03440.1.1	177	1	178	EXT3_DROME	178	794	972	6.11e-97	79.888	99	87.71	1	1	300	768
Dcitr09g03470.1.1	85	1	86	GSH1_DROME	85	1	86	5.54e-41	77.907	98	88.37	0	0	141	355
Dcitr09g03480.1.1	204	1	205	GSH1_DROME	206	1	207	5.31e-107	74.396	90	84.54	1	2	323	827
Dcitr09g03480.1.2	204	1	205	GSH1_DROME	206	1	207	5.31e-107	74.396	90	84.54	1	2	323	827
Dcitr09g03480.1.3	204	1	205	GSH1_DROME	206	1	207	5.31e-107	74.396	90	84.54	1	2	323	827
Dcitr09g03480.1.4	204	1	205	GSH1_DROME	206	1	207	5.31e-107	74.396	90	84.54	1	2	323	827
Dcitr09g03480.1.5	204	1	205	GSH1_DROME	206	1	207	5.31e-107	74.396	90	84.54	1	2	323	827
Dcitr09g03640.1.1	172	1	173	Q9VFB5_DROME	172	1	173	6.64e-112	87.861	99	92.49	0	0	315	806
Dcitr09g03660.1.1	172	1	173	Q9VFB5_DROME	172	1	173	6.64e-112	87.861	99	92.49	0	0	315	806
Dcitr09g03670.1.1	172	1	173	Q9VFB5_DROME	172	1	173	6.64e-112	87.861	99	92.49	0	0	315	806
Dcitr09g03680.1.1	353	1	354	CAMKI_MACNP	330	1	331	0.0	75.493	93	83.38	2	25	548	1412
Dcitr09g03700.1.1	254	96	350	Q9VHJ5_DROME	254	1	255	9.81e-141	71.373	84	87.45	0	0	399	1024
Dcitr09g03710.1.1	219	8	227	Q9VRQ1_DROME	218	43	261	2.12e-118	71.818	96	84.09	1	1	337	864
Dcitr09g03710.1.1	216	8	224	M9PHI7_DROME	215	43	258	9.13e-116	71.429	95	83.87	1	1	330	847
Dcitr09g04220.1.1	458	72	530	GPRK2_DROME	459	242	701	0.0	72.885	97	83.30	2	3	713	1840
Dcitr09g04310.1.1	610	152	762	Q9VZP5_DROME	605	539	1144	0.0	76.268	80	87.40	1	5	993	2568
Dcitr09g04310.1.1	610	152	762	Q9NJH7_DROME	605	539	1144	0.0	76.268	80	87.40	1	5	992	2565
Dcitr09g04310.1.1	610	152	762	M9ND37_DROME	569	539	1108	0.0	71.358	80	81.83	2	41	908	2347
Dcitr09g04310.1.2	610	152	762	Q9VZP5_DROME	605	539	1144	0.0	76.268	80	87.40	1	5	993	2568
Dcitr09g04310.1.2	610	152	762	Q9NJH7_DROME	605	539	1144	0.0	76.268	80	87.40	1	5	992	2565
Dcitr09g04310.1.2	610	152	762	M9ND37_DROME	569	539	1108	0.0	71.358	80	81.83	2	41	908	2347
Dcitr09g04430.1.1	1174	1	1175	RPB2_DROME	1174	2	1176	0.0	92.000	99	95.40	0	0	2259	5855
Dcitr09g04610.1.1	240	1	241	Q9VKR0_DROME	236	1	237	9.09e-128	70.954	99	84.65	2	4	361	926
Dcitr09g05040.1.1	176	26	202	Q9VH23_DROME	176	40	216	1.11e-86	70.621	78	82.49	0	0	269	688
Dcitr09g05220.1.1	357	18	375	Q9VD58_DROME	359	10	369	0.0	73.889	95	86.67	1	2	545	1403
Dcitr09g05230.1.1	307	1	308	KC1A_DROME	307	4	311	0.0	79.870	83	89.94	0	0	533	1373
Dcitr09g05640.1.1	368	2	370	2ABA_DROME	368	60	428	0.0	84.011	87	92.95	0	0	671	1730
Dcitr09g05680.1.1	461	151	612	DDX3_DROME	457	238	695	0.0	74.082	72	85.53	3	6	700	1807
Dcitr09g05720.1.1	441	2	443	2ABA_DROME	441	58	499	0.0	83.937	99	92.99	0	0	803	2075
Dcitr09g06020.1.1	109	1	110	Q9VJ19_DROME	109	1	110	1.74e-66	85.455	97	91.82	0	0	195	495
Dcitr09g06020.1.1	109	1	110	Q8MT23_DROME	109	1	110	1.01e-65	84.545	97	90.91	0	0	193	490
Dcitr09g06250.1.1	616	1	617	HSP7D_DROME	611	1	612	0.0	87.520	95	94.00	1	5	1131	2926
Dcitr09g06250.1.1	642	5	647	HSP75_DROME	639	2	641	0.0	73.628	99	83.99	5	29	987	2551
Dcitr09g06250.1.1	642	5	647	HSP73_DROME	639	2	641	0.0	73.628	99	83.99	5	29	987	2551
Dcitr09g06260.1.1	298	8	306	ADT_DROME	296	16	312	1.89e-166	73.913	97	85.95	2	2	464	1194
Dcitr09g06910.1.1	276	16	292	Q9NB16_DROME	267	5	272	3.87e-140	70.504	94	82.73	2	11	395	1015
Dcitr09g06910.1.1	277	16	293	Q9VGV3_DROME	268	23	291	3.10e-135	70.251	94	84.23	2	11	384	985
Dcitr09g06940.1.1	106	239	345	Q9W4X6_DROME	106	176	282	5.86e-53	72.897	98	85.98	0	0	176	447
Dcitr09g06940.1.1	106	239	345	Q9NB16_DROME	106	146	252	2.63e-53	72.897	98	85.98	0	0	176	447
Dcitr09g06940.1.1	106	239	345	Q9VGV3_DROME	106	164	270	1.52e-54	74.766	93	86.92	0	0	180	456
Dcitr09g07300.1.1	210	25	235	PSMD1_DROME	211	643	854	1.53e-108	78.774	78	89.62	1	1	339	870
Dcitr09g07580.1.1	89	547	636	Q8INQ6_DROME	89	805	894	9.04e-43	78.889	77	91.11	0	0	165	417
Dcitr09g07580.1.1	89	547	636	A0A0B4KFU6_DROME	89	805	894	1.00e-42	78.889	77	91.11	0	0	165	417
Dcitr09g07600.1.1	184	1	185	PSMD1_DROME	185	669	854	1.04e-91	77.957	82	89.78	1	1	293	749
Dcitr09g07720.1.1	61	14	75	Q7JWD6_DROME	61	10	71	1.32e-36	85.484	79	95.16	0	0	118	296
Dcitr09g07730.1.1	107	14	121	Q7JWD6_DROME	107	10	117	1.05e-72	90.741	89	96.30	0	0	211	538
Dcitr09g07730.1.1	97	24	121	Q7KYI0_DROME	97	1	98	1.14e-65	91.837	80	96.94	0	0	193	490
Dcitr09g08010.1.1	205	1	206	RS8_DROME	207	1	208	6.50e-106	74.519	99	85.10	1	2	302	774
Dcitr09g08060.1.1	124	1	125	EIF3A_DROME	126	1	127	6.34e-58	75.591	100	85.83	1	2	192	487
Dcitr09g08140.1.1	17	477	494	A0A0B4K6B7_DROME	17	685	702	0.016	88.889	90	100.00	0	0	39.3	90
Dcitr09g08140.1.1	17	477	494	A0A0B4K679_DROME	17	995	1012	0.015	88.889	87	100.00	0	0	39.3	90
Dcitr09g08140.1.1	17	477	494	A0A0B4K6L8_DROME	17	685	702	0.015	88.889	88	100.00	0	0	39.3	90
Dcitr09g08140.1.2	17	493	510	A0A0B4K6L8_DROME	17	685	702	0.016	88.889	88	100.00	0	0	39.3	90
Dcitr09g08140.1.2	17	493	510	A0A0B4K6B7_DROME	17	685	702	0.016	88.889	88	100.00	0	0	39.3	90
Dcitr09g08140.1.2	17	493	510	A0A0B4K679_DROME	17	995	1012	0.015	88.889	88	100.00	0	0	39.3	90
Dcitr09g08150.1.1	34	585	619	A0A0B4JD62_DROME	34	2229	2263	1.19e-09	80.000	83	88.57	0	0	62.8	151
Dcitr09g08150.1.1	34	585	619	A0A0B4JDB5_DROME	34	2230	2264	1.20e-09	80.000	83	88.57	0	0	62.8	151
Dcitr09g08150.1.1	34	585	619	A0A0B4JCV6_DROME	34	2423	2457	1.22e-09	80.000	83	88.57	0	0	62.8	151
Dcitr09g08410.1.1	106	2	108	A0A0B4JD62_DROME	105	2158	2263	2.28e-43	72.897	98	85.05	1	1	162	411
Dcitr09g08410.1.1	106	2	108	A0A0B4JDB5_DROME	105	2159	2264	2.28e-43	72.897	98	85.05	1	1	162	411
Dcitr09g08410.1.1	106	2	108	A0A0B4LHQ4_DROME	105	2130	2235	2.41e-43	72.897	98	85.05	1	1	162	411
Dcitr09g08730.1.1	489	3	492	VATB_DROME	489	1	490	0.0	93.878	99	98.16	0	0	966	2497
Dcitr09g08730.1.2	401	3	404	VATB_DROME	401	1	402	0.0	93.035	94	98.01	0	0	781	2017
Dcitr09g08730.1.3	489	3	492	VATB_DROME	489	1	490	0.0	93.878	99	98.16	0	0	966	2497
Dcitr09g08730.1.4	489	3	492	VATB_DROME	489	1	490	0.0	93.878	99	98.16	0	0	966	2497
Dcitr09g08760.1.1	112	1	113	TTKB_DROME	112	3	115	1.81e-67	83.186	100	92.92	0	0	213	542
Dcitr09g08760.1.1	112	1	113	TTKA_DROME	112	3	115	2.91e-66	83.186	100	92.92	0	0	213	541
Dcitr09g08760.1.2	112	1	113	TTKB_DROME	112	3	115	1.81e-67	83.186	100	92.92	0	0	213	542
Dcitr09g08760.1.2	112	1	113	TTKA_DROME	112	3	115	2.91e-66	83.186	100	92.92	0	0	213	541
Dcitr09g08760.1.3	112	1	113	TTKB_DROME	112	3	115	1.81e-67	83.186	100	92.92	0	0	213	542
Dcitr09g08760.1.3	112	1	113	TTKA_DROME	112	3	115	2.91e-66	83.186	100	92.92	0	0	213	541
Dcitr09g09230.1.1	93	6	99	EBI_DROME	93	601	694	2.55e-52	85.106	92	92.55	0	0	173	438
Dcitr09g09250.1.1	368	130	498	EBI_DROME	365	335	700	0.0	80.759	92	89.97	1	3	644	1660
Dcitr09g09250.1.1	88	5	93	EBI_DROME	88	1	89	1.47e-38	78.652	92	88.76	0	0	149	375
Dcitr09g09350.1.1	377	45	422	SUV3_DROME	374	46	420	0.0	70.635	90	84.13	2	3	577	1488
Dcitr10g01240.1.1	187	20	207	NRBP_DROME	187	81	268	2.45e-106	78.307	88	88.36	2	2	318	815
Dcitr10g01240.1.2	187	20	207	NRBP_DROME	187	81	268	2.45e-106	78.307	88	88.36	2	2	318	815
Dcitr10g01240.1.3	187	20	207	NRBP_DROME	187	81	268	2.45e-106	78.307	88	88.36	2	2	318	815
Dcitr10g01240.1.4	187	20	207	NRBP_DROME	187	81	268	2.45e-106	78.307	88	88.36	2	2	318	815
Dcitr10g01240.1.5	187	20	207	NRBP_DROME	187	81	268	2.45e-106	78.307	88	88.36	2	2	318	815
Dcitr10g01300.1.1	192	3	195	PRDX1_DROME	192	2	194	2.93e-112	75.130	98	87.05	0	0	317	813
Dcitr10g01340.1.1	407	1	408	LIS1_DROME	410	1	411	0.0	70.316	99	83.94	2	3	602	1553
Dcitr10g01390.1.1	322	23	345	CSN5_DROME	319	2	321	0.0	78.947	90	90.40	1	3	558	1437
Dcitr10g01400.1.1	111	1	112	RL36_DROME	109	1	110	1.82e-53	75.000	97	83.04	1	2	162	411
Dcitr10g01400.1.2	111	1	112	RL36_DROME	109	1	110	1.82e-53	75.000	97	83.04	1	2	162	411
Dcitr10g01460.1.1	386	60	446	Q8T030_DROME	373	39	412	0.0	83.979	86	87.34	1	13	667	1720
Dcitr10g01460.1.1	386	60	446	Q23994_DROME	373	39	412	0.0	83.721	86	87.08	1	13	666	1718
Dcitr10g01460.1.1	386	60	446	Q8IQ91_DROME	373	39	412	0.0	83.979	86	87.34	1	13	666	1718
Dcitr10g01490.1.1	287	10	297	Q8T0H4_DROME	287	170	457	8.21e-156	72.569	93	82.99	0	0	443	1139
Dcitr10g01490.1.1	287	10	297	A1Z992_DROME	287	392	679	3.32e-152	72.569	93	82.99	0	0	441	1135
Dcitr10g01840.1.1	184	15	199	Q9W0I2_DROME	180	5	185	2.05e-99	70.811	93	83.24	2	4	285	729
Dcitr10g01840.1.1	156	43	199	Q8IRH8_DROME	155	218	373	1.59e-98	81.529	79	91.72	1	1	290	741
Dcitr10g01920.1.1	304	63	367	DAT_DROME	319	24	343	7.99e-169	75.851	80	82.66	4	21	485	1248
Dcitr10g02070.1.1	190	1	191	Q9W1E8_DROME	190	1	191	1.96e-126	87.435	99	95.29	0	0	353	905
Dcitr10g02250.1.1	127	1	128	MED10_DROME	128	1	129	5.14e-66	71.318	93	86.82	1	1	196	497
Dcitr10g02360.1.1	127	1	128	MED10_DROME	128	1	129	5.14e-66	71.318	93	86.82	1	1	196	497
Dcitr10g02920.1.1	241	1	242	PSA4_DROME	245	1	246	5.68e-134	75.610	92	82.52	1	4	378	970
Dcitr10g02920.1.2	241	1	242	PSA4_DROME	245	1	246	5.68e-134	75.610	92	82.52	1	4	378	970
Dcitr10g02950.1.1	176	2	178	O97066_DROME	176	9	185	2.84e-111	83.051	99	92.66	0	0	314	804
Dcitr10g02950.1.1	176	2	178	Q3YMT4_DROME	176	9	185	2.85e-111	83.051	99	92.66	0	0	314	804
Dcitr10g02990.1.1	215	7	222	RL10_DROME	215	1	216	2.01e-147	89.815	96	93.98	0	0	409	1050
Dcitr10g03230.1.1	177	4	181	NOS_DROME	177	285	462	5.23e-91	72.472	97	84.83	0	0	288	738
Dcitr10g03560.1.1	89	4	93	RUXE_DROME	89	2	91	3.50e-48	75.556	91	90.00	0	0	147	372
Dcitr10g03910.1.1	414	1	415	O76928_DROME	414	1	415	0.0	72.488	100	85.89	3	6	651	1680
Dcitr10g04110.1.1	126	14	140	Q9W2Z3_DROME	126	47	173	1.83e-72	77.165	89	89.76	0	0	234	597
Dcitr10g04110.1.1	126	14	140	M9NGY0_DROME	126	47	173	1.93e-72	77.165	89	89.76	0	0	234	597
Dcitr10g04110.1.1	126	14	140	M9NDS9_DROME	126	47	173	3.72e-72	77.165	89	89.76	0	0	233	595
Dcitr10g04120.1.1	232	1	233	M9NF05_DROME	233	172	405	2.00e-122	73.077	86	88.03	1	1	384	985
Dcitr10g04120.1.1	232	1	233	A8JUP3_DROME	233	172	405	4.62e-122	73.077	86	88.03	1	1	383	983
Dcitr10g04120.1.1	232	1	233	M9NG70_DROME	233	172	405	9.82e-122	73.077	86	88.03	1	1	377	967
Dcitr10g04130.1.1	68	9	77	Q9W2Z3_DROME	68	503	571	2.14e-37	79.710	83	86.96	0	0	137	346
Dcitr10g04130.1.1	68	9	77	M9NGY0_DROME	68	503	571	3.54e-37	79.710	83	86.96	0	0	137	344
Dcitr10g04130.1.1	68	9	77	M9NDS9_DROME	68	503	571	4.09e-37	79.710	83	86.96	0	0	136	343
Dcitr10g04300.1.1	682	6	688	GYS_DROME	686	22	708	0.0	71.491	99	82.49	4	12	1027	2656
Dcitr10g04340.1.1	56	35	91	O77430_DROME	56	106	162	7.54e-33	91.228	99	96.49	0	0	110	276
Dcitr10g04340.1.1	56	35	91	Q7KJ69_DROME	56	105	161	2.85e-28	78.947	99	89.47	0	0	99.4	246
Dcitr10g04350.1.1	93	1	94	O77430_DROME	93	1	94	2.48e-46	75.532	95	85.11	0	0	145	366
Dcitr10g04360.1.1	161	1	162	O77430_DROME	161	1	162	4.95e-96	82.716	99	90.12	0	0	274	700
Dcitr10g04360.1.1	161	1	162	Q7KJ69_DROME	160	1	161	3.59e-83	73.457	99	85.19	1	1	241	615
Dcitr10g04440.1.1	482	1	483	MYSA_DROME	438	91	529	0.0	76.605	85	83.85	3	44	768	1982
Dcitr10g04460.1.1	495	1	496	MYSA_DROME	434	288	722	0.0	72.177	99	79.23	3	61	667	1720
Dcitr10g04460.1.2	438	1	439	MYSA_DROME	434	288	722	0.0	81.549	99	89.52	1	4	698	1802
Dcitr10g04460.1.3	438	1	439	MYSA_DROME	434	288	722	0.0	84.055	99	91.12	1	4	721	1862
Dcitr10g04460.1.4	438	1	439	MYSA_DROME	434	288	722	0.0	81.777	99	89.75	1	4	703	1814
Dcitr10g04470.1.1	162	104	266	MYSA_DROME	162	1128	1290	1.71e-63	75.460	98	85.28	0	0	215	548
Dcitr10g04470.1.2	162	104	266	MYSA_DROME	162	1128	1290	1.71e-63	75.460	98	85.28	0	0	215	548
Dcitr10g04650.1.1	245	1	246	RTCB_DROME	249	1	250	1.14e-158	85.600	84	92.80	1	4	451	1160
Dcitr10g04740.1.1	505	1	506	RTCB_DROME	505	1	506	0.0	89.130	81	95.45	0	0	946	2444
Dcitr10g04770.1.1	493	1	494	RTCB_DROME	505	1	506	0.0	86.957	99	93.28	1	12	914	2361
Dcitr10g04990.1.1	712	1	713	ATC1_DROME	708	1	709	0.0	87.377	99	93.69	2	4	1272	3292
Dcitr10g05010.1.1	282	1	283	ATC1_DROME	282	733	1015	1.16e-167	85.866	98	93.64	0	0	490	1262
Dcitr10g05090.1.1	280	14	294	Q7JZ62_DROME	284	15	299	1.04e-155	74.476	95	84.97	4	6	436	1121
Dcitr10g05300.1.1	140	1	141	O62602_DROME	139	188	327	1.58e-72	70.922	98	82.27	1	1	219	559
Dcitr10g05300.1.1	140	1	141	Q9U983_DROME	139	188	327	1.67e-72	70.922	98	82.27	1	1	219	559
Dcitr10g05370.1.1	684	1	685	X2JDW0_DROME	693	389	1082	0.0	70.630	99	83.67	8	17	1025	2649
Dcitr10g05370.1.1	684	1	685	Q9W581_DROME	694	389	1083	0.0	70.774	99	83.67	8	16	1023	2646
Dcitr10g05370.1.1	684	1	685	Q8MM14_DROME	694	208	902	0.0	70.774	99	83.67	8	16	1022	2642
Dcitr10g06000.1.1	2318	68	2386	A1Z8U0_DROME	2319	77	2396	0.0	93.839	97	97.41	3	3	4535	11762
Dcitr10g06040.1.1	324	1	325	A1Z8U0_DROME	325	206	531	0.0	88.037	100	94.48	1	1	608	1568
Dcitr10g06120.1.1	58	1	59	LOLA2_DROME	58	1	59	1.48e-29	79.661	97	91.53	0	0	107	267
Dcitr10g06120.1.1	56	1	57	LOLA3_DROME	56	1	57	2.21e-29	82.456	93	92.98	0	0	107	267
Dcitr10g06120.1.1	58	1	59	LOLA6_DROME	58	1	59	3.02e-29	79.661	97	91.53	0	0	107	266
Dcitr10g06310.1.1	208	1	209	CRCM1_DROME	210	133	343	9.05e-118	81.991	95	90.05	1	2	338	867
Dcitr10g06340.1.1	118	1	119	CRCM1_DROME	125	191	316	5.96e-52	71.429	87	78.95	2	21	167	423
Dcitr10g06480.1.1	109	1	110	TBG1_DROME	109	1	110	1.40e-66	84.545	87	90.91	0	0	207	528
Dcitr10g06480.1.1	109	1	110	TBG2_DROME	109	1	110	9.44e-66	81.818	87	90.91	0	0	205	521
Dcitr10g06510.1.1	628	1	629	HSP68_DROME	634	1	635	0.0	79.278	99	90.58	2	10	1067	2759
Dcitr10g06510.1.1	628	1	629	HSP71_DROME	641	1	642	0.0	78.428	99	88.60	3	27	1058	2736
Dcitr10g06510.1.1	628	1	629	HSP70_DROME	641	1	642	0.0	78.428	99	88.60	3	27	1058	2736
Dcitr10g06720.1.1	389	8	397	Q9W388_DROME	389	10	399	0.0	90.256	98	94.62	0	0	707	1825
Dcitr10g06720.1.1	389	8	397	Q7KVR7_DROME	389	23	412	0.0	90.256	98	94.62	0	0	706	1821
Dcitr10g06720.1.1	389	8	397	Q86B59_DROME	395	10	405	0.0	88.889	98	93.18	1	6	699	1805
Dcitr10g06910.1.1	151	40	191	Q7KLW9_DROME	151	353	504	3.42e-87	76.974	79	88.82	0	0	264	675
Dcitr10g06930.1.1	105	40	145	Q7KLW9_DROME	105	353	458	8.32e-57	77.358	73	87.74	0	0	184	466
Dcitr10g07040.1.1	625	1	626	HSP68_DROME	634	1	635	0.0	79.370	99	90.39	1	9	1066	2758
Dcitr10g07040.1.1	625	1	626	HSP71_DROME	641	1	642	0.0	78.816	99	89.25	2	16	1056	2732
Dcitr10g07040.1.1	625	1	626	HSP70_DROME	641	1	642	0.0	78.816	99	89.25	2	16	1056	2732
Dcitr10g07150.1.1	628	1	629	HSP68_DROME	634	1	635	0.0	79.278	99	90.58	2	10	1066	2756
Dcitr10g07150.1.1	628	1	629	HSP71_DROME	641	1	642	0.0	78.582	99	88.60	3	27	1059	2738
Dcitr10g07150.1.1	628	1	629	HSP70_DROME	641	1	642	0.0	78.582	99	88.60	3	27	1059	2738
Dcitr10g07240.1.1	635	62	697	HIL_DROME	639	179	818	0.0	73.406	91	85.07	6	10	978	2528
Dcitr10g07310.1.1	158	1	159	Q7KNM2_DROME	158	1	159	7.51e-109	90.566	99	94.34	0	0	306	783
Dcitr10g07340.1.1	136	1	137	Q7KNM2_DROME	136	1	137	4.58e-93	90.511	99	94.89	0	0	265	677
Dcitr10g07530.1.1	94	1	95	FLII_DROME	94	1159	1253	7.93e-44	71.579	95	80.00	0	0	150	379
Dcitr10g07730.1.1	396	113	509	TBA1_DROME	396	43	439	0.0	94.207	76	98.74	0	0	773	1997
Dcitr10g07730.1.1	396	113	509	TBA3_DROME	396	43	439	0.0	93.703	76	98.49	0	0	769	1987
Dcitr10g07730.1.1	404	113	517	TBA2_DROME	405	43	448	0.0	91.133	78	96.55	1	1	763	1970
Dcitr10g08030.1.1	246	1	247	TPIS_DROME	246	1	247	7.46e-124	70.040	99	78.54	0	0	351	901
Dcitr10g08050.1.1	246	1	247	TPIS_DROME	246	1	247	7.46e-124	70.040	99	78.54	0	0	351	901
Dcitr10g08280.1.1	212	1	213	Q9VJW1_DROME	220	640	860	2.70e-105	72.398	92	82.81	2	8	332	851
Dcitr10g08360.1.1	138	2	140	Q9VRL1_DROME	138	7	145	2.84e-80	73.381	99	89.21	0	0	232	592
Dcitr10g08360.1.1	136	4	140	Q8IGH9_DROME	136	1	137	1.21e-78	72.993	97	89.05	0	0	228	581
Dcitr10g08770.1.1	160	65	225	UBCD2_DROME	160	72	232	4.03e-113	93.168	71	96.27	0	0	322	826
Dcitr10g09030.1.1	760	12	772	UBIQP_DROME	760	1	761	0.0	99.737	99	99.87	0	0	1496	3874
Dcitr10g09030.1.1	694	3	697	UBIQP_DROME	694	68	762	0.0	98.561	99	98.99	0	0	1350	3493
Dcitr10g09030.1.1	531	12	543	Q9W418_DROME	531	1	532	0.0	99.812	98	100.00	0	0	1048	2711
Dcitr10g09030.1.1	531	88	619	Q9W418_DROME	531	1	532	0.0	99.812	98	100.00	0	0	1048	2711
Dcitr10g09030.1.1	531	164	695	Q9W418_DROME	531	1	532	0.0	99.812	98	100.00	0	0	1048	2711
Dcitr10g09030.1.1	531	240	771	Q9W418_DROME	531	1	532	0.0	99.812	98	100.00	0	0	1048	2711
Dcitr10g09030.1.1	303	12	315	Q8MT02_DROME	303	1	304	0.0	100.000	98	100.00	0	0	601	1550
Dcitr10g09030.1.1	303	88	391	Q8MT02_DROME	303	1	304	0.0	100.000	98	100.00	0	0	601	1550
Dcitr10g09030.1.1	303	468	771	Q8MT02_DROME	303	1	304	0.0	100.000	98	100.00	0	0	601	1550
Dcitr10g09030.1.1	303	164	467	Q8MT02_DROME	303	1	304	0.0	99.671	98	100.00	0	0	600	1547
Dcitr10g09030.1.1	303	240	543	Q8MT02_DROME	303	1	304	0.0	99.671	98	100.00	0	0	600	1547
Dcitr10g09030.1.1	303	316	619	Q8MT02_DROME	303	1	304	0.0	99.671	98	100.00	0	0	600	1547
Dcitr10g09030.1.1	303	392	695	Q8MT02_DROME	303	1	304	0.0	99.671	98	100.00	0	0	600	1547
Dcitr10g09060.1.1	531	1	532	Q9W418_DROME	531	1	532	0.0	100.000	99	100.00	0	0	1049	2713
Dcitr10g09060.1.1	532	1	533	UBIQP_DROME	532	1	533	0.0	99.812	99	99.81	0	0	1049	2713
Dcitr10g09060.1.1	532	1	533	UBIQP_DROME	532	77	609	0.0	99.812	99	99.81	0	0	1049	2713
Dcitr10g09060.1.1	532	1	533	UBIQP_DROME	532	153	685	0.0	99.812	99	99.81	0	0	1049	2713
Dcitr10g09060.1.1	532	1	533	UBIQP_DROME	532	229	761	0.0	99.812	99	99.81	0	0	1049	2712
Dcitr10g09060.1.1	457	1	458	UBIQP_DROME	457	305	762	0.0	99.782	99	100.00	0	0	902	2330
Dcitr10g09060.1.1	303	1	304	Q8MT02_DROME	303	1	304	0.0	100.000	99	100.00	0	0	602	1552
Dcitr10g09060.1.1	303	77	380	Q8MT02_DROME	303	1	304	0.0	100.000	99	100.00	0	0	602	1552
Dcitr10g09060.1.1	303	153	456	Q8MT02_DROME	303	1	304	0.0	100.000	99	100.00	0	0	602	1552
Dcitr10g09060.1.1	303	229	532	Q8MT02_DROME	303	1	304	0.0	100.000	99	100.00	0	0	602	1552
Dcitr10g09450.1.1	129	1	130	M9NCR4_DROME	129	14837	14966	1.59e-56	77.692	99	89.23	0	0	218	554
Dcitr10g09450.1.1	129	1	130	M9NER8_DROME	129	15370	15499	1.64e-56	77.692	99	89.23	0	0	218	554
Dcitr10g09450.1.1	129	1	130	M9PCJ8_DROME	129	14557	14686	1.66e-56	77.692	99	89.23	0	0	218	554
Dcitr10g09490.1.1	184	1	185	Q8MQX8_DROME	182	49	231	5.86e-94	70.811	84	82.70	1	2	276	707
Dcitr10g09490.1.1	184	1	185	Q9U3W7_DROME	182	541	723	1.12e-87	70.811	84	82.70	1	2	274	701
Dcitr10g09490.1.1	184	1	185	M9NCR4_DROME	182	14837	15019	4.43e-86	70.811	84	82.70	1	2	277	709
Dcitr10g09930.1.1	139	2	141	ERKA_DROME	141	9	150	4.97e-78	80.986	99	85.21	1	2	234	598
Dcitr10g09960.1.1	67	1	68	ERKA_DROME	67	306	373	2.76e-27	70.588	97	79.41	0	0	100	249
Dcitr10g10150.1.1	80	30	110	SDK_DROME	80	2144	2224	5.98e-46	91.358	73	96.30	0	0	157	396
Dcitr10g10190.1.1	129	1	130	RS15A_DROME	129	1	130	1.47e-88	93.077	99	96.92	0	0	252	644
Dcitr10g10190.1.2	129	1	130	RS15A_DROME	129	1	130	1.47e-88	93.077	99	96.92	0	0	252	644
Dcitr10g10190.1.3	129	1	130	RS15A_DROME	129	1	130	1.47e-88	93.077	99	96.92	0	0	252	644
Dcitr10g10340.1.1	76	1600	1676	M9MRK7_DROME	76	5015	5091	8.20e-33	79.221	92	92.21	0	0	139	350
Dcitr10g10340.1.1	76	1600	1676	M9MRP6_DROME	76	4994	5070	8.20e-33	79.221	92	92.21	0	0	139	350
Dcitr10g10340.1.1	76	1600	1676	X2JAP2_DROME	76	5009	5085	8.06e-33	79.221	92	92.21	0	0	139	350
Dcitr10g10350.1.1	76	339	415	X2JA38_DROME	76	5049	5125	3.32e-35	79.221	97	92.21	0	0	138	347
Dcitr10g10350.1.1	76	339	415	M9MRK7_DROME	76	5015	5091	3.14e-35	79.221	97	92.21	0	0	138	348
Dcitr10g10350.1.1	76	339	415	M9MRV1_DROME	76	4995	5071	3.38e-35	79.221	97	92.21	0	0	138	347
Dcitr10g10640.1.1	82	1	83	RS21_DROME	82	1	83	1.72e-43	77.108	99	84.34	0	0	135	339
Dcitr10g10670.1.1	145	7	152	NCBP2_DROME	145	3	148	7.41e-87	78.082	94	90.41	0	0	250	638
Dcitr10g10840.1.1	129	1	130	NH2L1_DROME	126	1	127	8.55e-74	79.231	99	90.00	1	3	215	547
Dcitr10g11030.1.1	329	4	333	G3P1_DROME	329	3	332	0.0	73.939	90	83.64	0	0	510	1314
Dcitr10g11030.1.1	329	4	333	G3P2_DROME	329	3	332	0.0	73.939	90	83.33	0	0	508	1308
Dcitr11g01260.1.1	279	78	357	TAO_DROME	281	1	282	2.09e-174	83.333	76	90.07	1	2	512	1318
Dcitr11g01290.1.1	671	1	672	SCNA_DROME	670	1338	2008	0.0	89.137	99	94.49	1	1	1245	3222
Dcitr11g01290.1.1	42	677	719	SCNA_DROME	43	2088	2131	3.03e-11	75.000	99	84.09	1	1	66.6	161
Dcitr11g01310.1.1	439	9	448	SCNA_DROME	438	1570	2008	0.0	87.955	97	93.86	1	1	808	2087
Dcitr11g01310.1.1	42	453	495	SCNA_DROME	43	2088	2131	1.66e-11	75.000	97	84.09	1	1	66.6	161
Dcitr11g01320.1.1	364	13	377	SCNA_DROME	392	772	1164	2.73e-174	73.282	96	80.66	2	28	534	1375
Dcitr11g01340.1.1	270	1	271	SCNA_DROME	271	1	272	6.45e-159	87.868	99	92.28	1	1	486	1252
Dcitr11g01410.1.1	355	145	500	DSOR1_DROME	342	47	389	0.0	74.438	97	82.30	2	13	534	1376
Dcitr11g01930.1.1	89	37	126	OMB_DROME	89	355	444	1.86e-52	88.889	71	93.33	0	0	176	446
Dcitr11g02000.1.1	119	1	120	Q8IM86_DROME	119	1990	2109	5.24e-66	80.833	88	87.50	0	0	215	548
Dcitr11g02000.1.1	119	1	120	H9XVP2_DROME	119	1993	2112	5.24e-66	80.833	88	87.50	0	0	215	548
Dcitr11g02000.1.1	119	1	120	X2J9E1_DROME	119	1678	1797	2.74e-65	80.833	88	87.50	0	0	213	543
Dcitr11g02020.1.1	886	1	887	H9XVP2_DROME	923	2263	3186	0.0	79.113	99	87.77	3	37	1538	3983
Dcitr11g02020.1.1	886	1	887	Q8IM86_DROME	923	2260	3183	0.0	79.113	99	87.77	3	37	1538	3981
Dcitr11g02020.1.1	886	1	887	L0MPR2_DROME	923	1788	2711	0.0	79.113	99	87.77	3	37	1536	3977
Dcitr11g02180.1.1	212	1	213	CSK2B_DROME	212	1	213	2.04e-153	91.080	96	96.71	0	0	424	1090
Dcitr11g02190.1.1	180	1	181	Q9VPX5_DROME	180	1	181	7.47e-112	82.320	99	91.16	0	0	315	808
Dcitr11g02190.1.1	168	8	176	Q2XYI2_DROME	168	1	169	1.11e-103	81.657	92	90.53	0	0	294	753
Dcitr11g02270.1.1	67	19	86	ORCO_DROME	67	419	486	5.49e-36	88.235	78	97.06	0	0	125	315
Dcitr11g02270.1.1	67	19	86	ORCO_AEDAE	67	411	478	1.70e-35	86.765	78	97.06	0	0	124	311
Dcitr11g02270.1.1	67	19	86	ORCO_ANOGA	67	411	478	1.85e-35	86.765	78	97.06	0	0	124	311
Dcitr11g02300.1.1	325	4	329	PP11_DROME	325	2	327	0.0	90.274	99	94.22	3	6	610	1572
Dcitr11g02300.1.1	298	5	303	PP12_DROME	298	3	301	0.0	93.645	91	97.32	0	0	587	1514
Dcitr11g02300.1.1	299	4	303	PP13_DROME	299	2	301	0.0	90.000	91	95.33	0	0	573	1476
Dcitr11g02340.1.1	305	4	309	PP11_DROME	305	2	307	0.0	91.176	73	94.77	0	0	590	1522
Dcitr11g02340.1.1	297	4	301	PP12_DROME	297	2	299	0.0	92.953	71	96.64	0	0	588	1517
Dcitr11g02340.1.1	297	4	301	PP13_DROME	297	2	299	0.0	89.933	71	94.97	0	0	575	1481
Dcitr11g02930.1.1	295	1	296	Q9VXQ5_DROME	294	239	533	8.00e-160	72.297	99	86.15	1	1	455	1171
Dcitr11g03060.1.1	331	1	332	Q9VXQ5_DROME	333	1	334	2.79e-167	73.952	99	88.92	1	2	493	1270
Dcitr11g03140.1.1	1685	1	1686	CLH_DROME	1668	1	1669	0.0	84.707	99	90.87	3	19	2939	7619
Dcitr11g03720.1.1	930	1	931	RENT1_DROME	931	1	932	0.0	76.013	82	86.99	6	13	1504	3893
Dcitr11g04110.1.1	460	12	472	Q9W1H8_DROME	458	11	469	0.0	72.138	97	85.10	2	6	712	1839
Dcitr11g04110.1.1	460	12	472	O77466_DROME	458	11	469	0.0	72.138	97	84.67	2	6	709	1830
Dcitr11g04110.1.2	460	12	472	Q9W1H8_DROME	458	11	469	0.0	72.138	97	85.10	2	6	712	1839
Dcitr11g04110.1.2	460	12	472	O77466_DROME	458	11	469	0.0	72.138	97	84.67	2	6	709	1830
Dcitr11g04410.1.1	307	5	312	PP4C_DROME	306	1	307	0.0	90.909	98	94.48	1	1	588	1515
Dcitr11g04420.1.1	102	14	116	PP4C_DROME	102	205	307	9.31e-68	90.291	88	94.17	0	0	205	522
Dcitr11g04480.1.1	279	17	296	Q9I7D0_DROME	287	5	292	4.41e-153	71.528	88	82.99	1	8	444	1143
Dcitr11g04590.1.1	130	52	182	Q8IR23_DROME	130	76	206	1.26e-70	80.916	77	90.08	0	0	229	584
Dcitr11g04890.1.1	151	6	157	NC2B_DROME	151	8	159	2.90e-70	71.053	89	82.89	0	0	209	533
Dcitr11g04900.1.1	300	17	317	Q7KSQ0_DROME	300	16	316	9.22e-175	77.409	94	87.04	0	0	486	1250
Dcitr11g05100.1.1	648	147	795	LONM_DROME	662	282	944	0.0	71.321	76	81.98	4	20	934	2414
Dcitr11g05470.1.1	187	1	188	Q9V3W7_DROME	188	1	189	2.54e-101	82.540	77	88.36	1	1	294	753
Dcitr11g05800.1.1	232	1	233	IMDH_DROME	232	305	537	5.04e-133	78.112	99	89.27	0	0	384	987
Dcitr11g05860.1.1	231	397	628	FLOT2_DROME	231	206	437	5.00e-115	71.552	99	91.81	0	0	350	898
Dcitr11g05910.1.1	386	1	387	FLOT2_DROME	399	38	437	0.0	71.000	99	86.75	1	13	580	1496
Dcitr11g06010.1.1	478	1	479	Q7JVY0_DROME	493	1	494	0.0	72.144	96	82.77	4	25	751	1938
Dcitr11g06010.1.1	478	1	479	A0A0B4KEJ7_DROME	500	1	501	0.0	71.344	96	81.82	5	32	746	1926
Dcitr11g06010.1.1	478	1	479	A0A0B4KEU5_DROME	499	1	500	0.0	71.287	96	81.78	5	31	743	1918
Dcitr11g06010.1.3	478	1	479	Q7JVY0_DROME	493	1	494	0.0	72.144	96	82.77	4	25	751	1938
Dcitr11g06010.1.3	478	1	479	A0A0B4KEJ7_DROME	500	1	501	0.0	71.344	96	81.82	5	32	746	1926
Dcitr11g06010.1.3	478	1	479	A0A0B4KEU5_DROME	499	1	500	0.0	71.287	96	81.78	5	31	743	1918
Dcitr11g06010.1.4	478	1	479	Q7JVY0_DROME	493	1	494	0.0	72.144	96	82.77	4	25	751	1938
Dcitr11g06010.1.4	478	1	479	A0A0B4KEJ7_DROME	500	1	501	0.0	71.344	96	81.82	5	32	746	1926
Dcitr11g06010.1.4	478	1	479	A0A0B4KEU5_DROME	499	1	500	0.0	71.287	96	81.78	5	31	743	1918
Dcitr11g06370.1.1	276	38	314	ACH4_DROME	276	24	300	5.40e-160	79.061	84	88.45	0	0	456	1174
Dcitr11g06370.1.1	274	40	314	ACH1_DROME	274	21	295	4.15e-152	72.727	83	89.09	0	0	438	1126
Dcitr11g06420.1.1	478	1	479	Q7JVY0_DROME	493	1	494	0.0	71.944	96	82.77	4	25	749	1933
Dcitr11g06420.1.1	478	1	479	A0A0B4KEJ7_DROME	500	1	501	0.0	71.146	96	81.82	5	32	745	1923
Dcitr11g06420.1.1	478	1	479	A0A0B4KEU5_DROME	499	1	500	0.0	71.089	96	81.78	5	31	741	1914
Dcitr11g06420.1.2	478	1	479	Q7JVY0_DROME	493	1	494	0.0	71.944	96	82.77	4	25	749	1933
Dcitr11g06420.1.2	478	1	479	A0A0B4KEJ7_DROME	500	1	501	0.0	71.146	96	81.82	5	32	745	1923
Dcitr11g06420.1.2	478	1	479	A0A0B4KEU5_DROME	499	1	500	0.0	71.089	96	81.78	5	31	741	1914
Dcitr11g06420.1.3	478	1	479	Q7JVY0_DROME	493	1	494	0.0	71.944	96	82.77	4	25	749	1933
Dcitr11g06420.1.3	478	1	479	A0A0B4KEJ7_DROME	500	1	501	0.0	71.146	96	81.82	5	32	745	1923
Dcitr11g06420.1.3	478	1	479	A0A0B4KEU5_DROME	499	1	500	0.0	71.089	96	81.78	5	31	741	1914
Dcitr11g06590.1.1	368	1	369	Q24090_DROME	369	1	370	0.0	73.854	99	88.41	3	3	587	1513
Dcitr11g07010.1.1	88	12	100	DYL1_DROME	88	1	89	4.91e-65	100.000	88	100.00	0	0	190	483
Dcitr11g07010.1.1	88	12	100	DYL2_DROME	88	1	89	1.57e-64	98.876	88	100.00	0	0	189	479
Dcitr11g07070.1.1	283	1	284	TPM2_DROME	283	1	284	2.13e-148	77.113	99	88.03	0	0	416	1070
Dcitr11g07080.1.1	171	1	172	Q9W5X0_DROME	171	1	172	7.04e-105	81.977	85	92.44	0	0	299	766
Dcitr11g07080.1.1	157	15	172	F0JAF7_DROME	157	4	161	1.08e-92	80.380	78	91.14	0	0	268	685
Dcitr11g07290.1.1	476	1	477	Q8STG9_DROME	475	1	476	0.0	95.178	99	97.69	1	1	906	2341
Dcitr11g07560.1.1	368	1	369	FUR11_DROME	369	402	771	0.0	70.933	99	80.27	3	11	537	1383
Dcitr11g07560.1.1	368	1	369	FUR1C_DROME	369	402	771	0.0	70.933	99	80.27	3	11	533	1373
Dcitr11g07670.1.1	268	1	269	Q9VDY8_DROME	269	1	270	2.88e-150	72.963	99	83.70	1	1	420	1079
Dcitr11g07670.1.1	268	1	269	Q8T3L2_DROME	269	1	270	6.75e-149	72.963	99	83.33	1	1	416	1070
Dcitr11g07670.1.1	268	1	269	A0A0B4KGG5_DROME	270	1	271	3.07e-148	73.432	99	83.03	2	2	415	1066
Dcitr11g07670.1.2	268	1	269	Q9VDY8_DROME	269	1	270	2.88e-150	72.963	99	83.70	1	1	420	1079
Dcitr11g07670.1.2	268	1	269	Q8T3L2_DROME	269	1	270	6.75e-149	72.963	99	83.33	1	1	416	1070
Dcitr11g07670.1.2	268	1	269	A0A0B4KGG5_DROME	270	1	271	3.07e-148	73.432	99	83.03	2	2	415	1066
Dcitr11g07670.1.3	268	1	269	Q9VDY8_DROME	269	1	270	1.07e-149	72.222	99	84.07	1	1	418	1075
Dcitr11g07670.1.3	268	1	269	Q8T3L2_DROME	269	1	270	2.23e-148	72.222	99	83.70	1	1	415	1067
Dcitr11g07670.1.3	268	1	269	A0A0B4KGG5_DROME	270	1	271	5.09e-144	71.587	99	81.92	2	2	404	1038
Dcitr11g07740.1.1	191	1	192	RHO1_DROME	191	1	192	6.91e-135	93.229	99	96.88	0	0	374	961
Dcitr11g07770.1.1	448	270	718	HSP83_BOMMO	447	269	716	0.0	83.964	91	91.98	1	1	777	2006
Dcitr11g07770.1.1	205	11	216	HSP83_BOMMO	205	12	217	2.30e-122	88.350	91	95.63	0	0	381	978
Dcitr11g07770.1.1	448	270	718	HSP83_DROME	448	269	717	0.0	80.000	91	88.44	2	2	757	1954
Dcitr11g07770.1.1	205	11	216	HSP83_DROME	205	5	210	2.38e-120	87.379	91	95.15	0	0	376	965
Dcitr11g07900.1.1	547	1	548	CH60_DROME	548	1	549	0.0	81.967	96	92.17	1	1	906	2342
Dcitr11g07900.1.1	547	1	548	CH60C_DROME	549	4	553	0.0	75.091	96	88.73	2	2	841	2173
Dcitr11g07990.1.1	191	1	192	RHO1_DROME	191	1	192	6.91e-135	93.229	99	96.88	0	0	374	961
Dcitr11g08260.1.1	270	60	330	7UP1_DROME	259	193	452	5.79e-169	88.192	90	90.04	3	11	491	1263
Dcitr11g08260.1.1	273	321	594	7UP1_DROME	283	260	543	1.24e-150	78.041	90	81.76	5	34	444	1142
Dcitr11g08260.1.1	271	60	331	7UP2_DROME	260	193	453	4.72e-168	87.868	75	89.71	3	11	496	1276
Dcitr11g08260.1.1	182	321	503	7UP2_DROME	192	260	452	2.04e-81	71.220	75	74.63	5	34	270	691
Dcitr11g08420.1.1	297	18	315	ACH2_DROME	298	40	338	0.0	90.301	94	95.99	1	1	562	1449
Dcitr11g08420.1.1	309	3	312	ACH1_DROME	309	5	314	2.33e-170	72.903	97	86.13	0	0	484	1246
Dcitr11g08430.1.1	548	14	562	ACH1_DROME	558	4	562	0.0	70.423	97	81.16	8	28	776	2004
Dcitr11g08660.1.1	179	32	211	M9MS42_DROME	179	81	260	8.43e-91	76.111	76	87.22	0	0	283	723
Dcitr11g08660.1.1	179	32	211	Q8IRM7_DROME	179	88	267	1.10e-90	76.111	76	87.22	0	0	283	723
Dcitr11g08660.1.1	179	32	211	Q9W324_DROME	179	93	272	1.22e-90	76.111	76	87.22	0	0	283	723
Dcitr11g08900.1.1	131	1	132	RS17_DROME	130	1	131	7.46e-81	84.848	99	93.94	1	1	233	594
Dcitr11g09020.1.1	174	30	204	Q9VF27_DROME	174	43	217	5.42e-114	86.286	85	89.71	0	0	323	828
Dcitr11g09020.1.1	174	30	204	Q8SZF2_DROME	174	43	217	7.27e-113	85.714	85	89.14	0	0	320	821
Dcitr11g09130.1.2	515	145	660	KCNN_DROME	502	310	812	0.0	75.238	78	81.14	7	31	780	2014
Dcitr11g09130.1.3	420	10	430	KCNN_DROME	420	392	812	0.0	80.607	98	85.98	3	14	713	1841
Dcitr11g09140.1.1	363	1	364	ALF_DROME	360	1	361	0.0	80.495	99	87.91	2	3	583	1503
Dcitr11g09140.1.2	363	1	364	ALF_DROME	360	1	361	0.0	80.495	99	87.91	2	3	583	1503
Dcitr11g09140.1.3	363	1	364	ALF_DROME	360	1	361	0.0	79.121	99	86.54	2	3	570	1469
Dcitr11g09140.1.4	363	1	364	ALF_DROME	360	1	361	0.0	80.495	99	87.91	2	3	583	1503
Dcitr11g09140.1.5	363	1	364	ALF_DROME	360	1	361	0.0	80.495	99	87.91	2	3	583	1503
Dcitr11g09290.1.1	624	126	750	HSP83_BOMMO	704	12	716	0.0	76.771	83	84.14	4	82	1076	2783
Dcitr11g09290.1.1	624	126	750	HSP83_DROME	712	5	717	0.0	72.129	83	80.81	5	90	1032	2669
Dcitr11g09330.1.1	117	1	118	Q7JZW2_DROME	117	31	148	3.34e-76	87.288	99	94.92	0	0	221	563
Dcitr11g09330.1.1	117	1	118	A1ZAH8_DROME	117	30	147	3.45e-76	87.288	99	94.92	0	0	221	563
Dcitr11g09350.1.1	146	1	147	A1ZAH8_DROME	146	1	147	3.16e-86	85.714	99	93.88	0	0	248	632
Dcitr11g09350.1.1	144	3	147	Q7JZW2_DROME	144	4	148	4.85e-86	86.207	98	94.48	0	0	247	631
Dcitr11g09490.1.1	536	1	537	TCPG_DROME	537	1	538	0.0	77.348	98	88.21	5	11	856	2211
Dcitr11g09630.1.1	136	5	141	Q9V472_DROME	136	27	163	1.83e-65	74.453	89	82.48	0	0	221	563
Dcitr11g09880.1.1	377	13	390	Q9VBL1_DROME	383	34	417	0.0	77.835	97	86.08	5	14	592	1527
Dcitr11g09880.1.1	371	19	390	Q86P97_DROME	381	41	422	0.0	78.497	95	86.01	5	18	588	1517
Dcitr11g09890.1.1	390	54	444	Q8INJ8_DROME	382	662	1044	0.0	74.680	86	84.14	2	8	617	1591
Dcitr11g09890.1.1	390	54	444	Q9VGK8_DROME	382	415	797	0.0	74.680	86	84.14	2	8	615	1586
Dcitr11g09890.1.1	390	54	444	Q7KSQ2_DROME	382	333	715	0.0	74.680	86	84.14	2	8	614	1583
Dcitr11g09950.1.1	340	12	352	IDH3A_DROME	340	37	377	0.0	87.097	96	93.84	0	0	630	1625
Dcitr12g01190.1.1	294	1	295	CSW_DROME	297	1	298	4.53e-136	70.820	90	80.00	4	17	429	1104
Dcitr12g01190.1.1	130	871	1001	CSW_DROME	136	542	678	5.56e-51	70.073	90	80.29	1	6	193	490
Dcitr12g01650.1.1	87	1	88	RUXF_DROME	87	1	88	8.61e-45	72.727	99	82.95	0	0	138	348
Dcitr12g01790.1.1	179	1	180	ARF2_DROME	179	1	180	4.15e-121	88.333	99	96.11	0	0	338	868
Dcitr12g01790.1.1	176	1	177	ARF1_DROME	176	1	177	1.73e-113	84.746	98	90.40	0	0	319	818
Dcitr12g01860.1.1	287	1	288	Q24253_DROME	287	1	288	1.36e-180	92.014	93	96.18	0	0	521	1343
Dcitr12g01890.1.1	923	1	924	Q24253_DROME	920	1	921	0.0	78.503	99	85.78	6	25	1451	3755
Dcitr12g02280.1.1	151	1	152	Q9VT75_DROME	153	1	154	2.66e-93	82.468	97	90.91	1	2	268	685
Dcitr12g02350.1.1	151	1	152	Q9VT75_DROME	153	1	154	2.66e-93	82.468	97	90.91	1	2	268	685
Dcitr12g03070.1.1	184	1	185	128UP_DROME	185	1	186	2.17e-97	82.796	84	89.78	1	1	287	735
Dcitr12g03180.1.1	644	22	666	KPC1_DROME	650	26	676	0.0	78.354	96	87.65	5	16	1075	2781
Dcitr12g03260.1.1	211	38	249	STX1A_DROME	217	12	229	1.78e-109	78.636	84	85.91	2	10	317	811
Dcitr12g03270.1.1	76	1	77	STX1A_DROME	75	1	76	3.38e-33	75.641	83	87.18	2	3	115	288
Dcitr12g03330.1.1	440	11	451	RUVB2_DROME	440	8	448	0.0	79.138	94	91.16	0	0	736	1900
Dcitr12g03340.1.1	423	11	434	RUVB2_DROME	441	8	449	0.0	76.018	97	87.33	1	18	698	1801
Dcitr12g03350.1.1	634	3	637	Q9VSS1_DROME	605	2	607	0.0	79.055	99	86.61	2	29	1035	2677
Dcitr12g03360.1.1	317	7	324	RUVB2_DROME	331	8	339	0.0	75.904	97	86.45	1	14	521	1342
Dcitr12g03850.1.1	87	4	91	Q960F6_DROME	89	140	229	4.60e-52	84.444	92	93.33	1	2	167	422
Dcitr12g03850.1.1	87	4	91	A1A714_DROME	89	140	229	1.97e-51	84.444	92	93.33	1	2	167	422
Dcitr12g03880.1.1	157	1	158	Q7K126_DROME	157	687	844	1.38e-84	74.051	99	87.34	0	0	264	675
Dcitr12g04180.1.1	196	31	227	CLU_DROME	196	465	661	5.49e-117	84.772	84	93.91	0	0	363	932
Dcitr12g04230.1.1	594	26	620	CLU_DROME	582	86	668	0.0	71.429	94	82.86	4	12	902	2330
Dcitr12g04370.1.1	90	1	91	TAF2_DROME	90	712	802	2.77e-43	72.527	99	83.52	0	0	148	374
Dcitr12g04880.1.1	201	1	202	O15971_DROME	202	1	203	1.28e-121	81.281	99	89.66	1	1	342	876
Dcitr12g04880.1.1	188	4	192	O18338_DROME	188	3	191	1.31e-98	71.958	93	84.66	0	0	284	726
Dcitr12g04890.1.1	119	1	120	O15971_DROME	119	1	120	2.50e-81	93.333	98	98.33	0	0	236	603
Dcitr12g04890.1.1	116	4	120	O18338_DROME	116	3	119	3.66e-70	82.906	95	94.02	0	0	208	530
Dcitr12g04940.1.1	481	1	482	6PGD_DROME	480	1	481	0.0	70.807	99	81.78	3	3	682	1760
Dcitr12g04990.1.1	137	1	138	Q7JVG2_DROME	139	1	140	5.51e-75	75.000	90	86.43	1	2	221	562
Dcitr12g05040.1.1	131	1	132	Q7JVG2_DROME	139	1	140	3.49e-66	71.429	90	81.43	3	8	198	503
Dcitr12g05420.1.1	506	1	507	HSP7C_DROME	508	148	656	0.0	88.998	99	95.48	1	2	905	2338
Dcitr12g05420.1.2	506	1	507	HSP7C_DROME	508	148	656	0.0	88.998	99	95.48	1	2	905	2338
Dcitr12g05500.1.1	241	29	270	HSP7C_DROME	239	28	267	2.91e-157	90.496	86	94.21	1	2	452	1163
Dcitr12g05500.1.1	243	33	276	HSP7D_DROME	241	7	248	6.87e-123	73.061	86	84.49	3	4	364	935
Dcitr12g05500.1.1	243	33	276	HSP68_DROME	242	4	246	1.04e-117	70.732	86	82.52	4	5	350	899
Dcitr12g05670.1.1	274	1	275	Q8MQJ7_DROME	274	1	275	1.39e-123	70.504	91	81.29	3	6	385	990
Dcitr12g06010.1.1	128	1	129	EZ_DROME	128	630	758	5.95e-85	94.574	98	97.67	0	0	262	670
Dcitr12g06030.1.1	554	1	555	Q7KVP9_DROME	555	1	556	0.0	70.683	99	84.17	1	1	839	2167
Dcitr12g06030.1.1	530	25	555	Q9XYZ2_DROME	531	1	532	0.0	70.301	95	84.02	1	1	797	2059
Dcitr12g06040.1.1	645	19	664	Q9VIK1_DROME	636	23	659	0.0	70.988	97	83.64	7	13	968	2502
Dcitr12g06180.1.1	363	145	508	Q95VU9_DROME	354	276	630	0.0	76.374	82	84.89	2	9	563	1451
Dcitr12g06180.1.1	363	145	508	M9MRE4_DROME	354	470	824	0.0	76.374	83	84.89	2	9	563	1450
Dcitr12g06180.1.1	363	145	508	B5RJR1_DROME	354	288	642	0.0	76.374	88	84.89	2	9	563	1450
Dcitr12g06180.1.1	83	1	84	B5RJR1_DROME	85	1	86	8.57e-31	77.907	88	80.23	2	2	126	317
Dcitr12g06210.1.1	83	1	84	B5RJR1_DROME	85	1	86	3.37e-29	77.907	90	80.23	2	2	126	317
Dcitr12g06310.1.1	622	1	623	GPRK1_DROME	660	39	699	0.0	74.773	99	84.89	6	40	1020	2638
Dcitr12g06320.1.1	340	11	351	GPRK1_DROME	347	352	699	0.0	74.359	97	84.62	5	13	535	1379
Dcitr12g06740.1.1	243	6	249	HDAC1_DROME	243	4	247	0.0	97.131	93	100.00	0	0	511	1317
Dcitr12g07050.1.1	33	971	1004	SPT16_DROME	33	792	825	6.40e-10	79.412	96	88.24	0	0	62.8	151
Dcitr12g07080.1.1	576	1	577	Q7JQF6_DROME	576	208	784	0.0	78.163	99	89.43	0	0	985	2547
Dcitr12g07080.1.1	576	1	577	B7YZT1_DROME	576	208	784	0.0	77.643	99	89.25	0	0	984	2545
Dcitr12g07080.1.1	576	1	577	A1Z6F6_DROME	576	173	749	0.0	78.163	99	89.43	0	0	984	2545
Dcitr12g07090.1.1	291	1	292	A0A0B4KF30_DROME	291	242	533	0.0	80.137	96	91.44	0	0	519	1337
Dcitr12g07090.1.1	291	1	292	B7YZT1_DROME	291	242	533	0.0	80.137	96	91.44	0	0	518	1335
Dcitr12g07090.1.1	291	1	292	A1Z6F4_DROME	291	242	533	9.75e-180	79.795	96	91.10	0	0	515	1326
Dcitr12g07330.1.1	94	1	95	SLY1_DROME	94	1	95	5.42e-43	70.526	93	84.21	0	0	147	370
Dcitr12g07770.1.1	25	680	705	E75BC_DROME	27	1107	1134	0.009	71.429	84	85.71	1	2	38.9	89
Dcitr12g07770.1.1	25	680	705	E75BB_DROME	27	1320	1347	0.009	71.429	83	85.71	1	2	38.9	89
Dcitr12g07770.1.1	25	680	705	E75BA_DROME	27	1263	1290	0.007	71.429	80	85.71	1	2	39.3	90
Dcitr12g07770.1.2	25	680	705	E75BC_DROME	27	1107	1134	0.009	71.429	84	85.71	1	2	38.9	89
Dcitr12g07770.1.2	25	680	705	E75BB_DROME	27	1320	1347	0.009	71.429	83	85.71	1	2	38.9	89
Dcitr12g07770.1.2	25	680	705	E75BA_DROME	27	1263	1290	0.007	71.429	80	85.71	1	2	39.3	90
Dcitr12g07820.1.1	155	19	174	E75BC_DROME	160	237	397	5.50e-88	80.124	87	88.82	1	5	279	713
Dcitr12g07820.1.1	155	19	174	E75BB_DROME	160	450	610	1.88e-87	80.124	87	88.82	1	5	278	712
Dcitr12g07820.1.1	134	40	174	E75BA_DROME	139	414	553	1.11e-63	72.143	75	82.86	1	5	211	536
Dcitr12g08560.1.1	204	1	205	Q9VFE3_DROME	202	9	211	5.01e-93	72.947	99	85.51	3	6	270	690
Dcitr12g08790.1.1	147	16	163	Q7YU40_DROME	153	442	595	2.22e-68	70.701	73	77.71	4	12	225	574
Dcitr12g08790.1.1	147	16	163	A1Z700_DROME	153	442	595	4.39e-68	70.701	73	77.71	4	12	224	572
Dcitr12g08790.1.1	147	16	163	Q94882_DROME	153	395	548	4.91e-68	70.701	73	77.71	4	12	224	572
Dcitr12g08930.1.1	125	5	130	A8JUT4_DROME	125	3	128	2.09e-67	73.016	95	82.54	0	0	199	505
Dcitr12g08930.1.1	127	5	132	Q9VRD6_DROME	127	3	130	3.17e-67	71.094	96	82.03	0	0	198	504
Dcitr12g09210.1.1	187	1	188	RL18_DROME	187	1	188	3.53e-100	71.809	99	84.57	0	0	286	733
Dcitr12g09360.1.1	110	4	114	C1C5A0_DROME	108	809	917	1.00e-44	70.270	97	78.38	1	2	153	387
Dcitr12g09360.1.1	110	4	114	Q9VNR2_DROME	108	793	901	1.06e-44	70.270	97	78.38	1	2	153	387
Dcitr12g09360.1.1	110	4	114	Q7KTU2_DROME	108	926	1034	1.07e-44	70.270	97	78.38	1	2	153	387
Dcitr12g09370.1.1	360	1	361	C1C5A0_DROME	362	434	796	0.0	73.829	100	86.23	1	2	540	1390
Dcitr12g09370.1.1	360	1	361	Q8IPS6_DROME	362	441	803	0.0	73.829	100	86.23	1	2	540	1390
Dcitr12g09370.1.1	360	1	361	A8JNX2_DROME	362	514	876	0.0	73.829	100	86.23	1	2	539	1389
Dcitr12g09380.1.1	895	38	933	Q8IPS6_DROME	901	23	924	0.0	72.235	96	83.52	5	10	1309	3388
Dcitr12g09380.1.1	895	38	933	A8JNX2_DROME	901	96	997	0.0	72.235	96	83.52	5	10	1309	3387
Dcitr12g09380.1.1	895	38	933	C1C5A0_DROME	901	16	917	0.0	72.235	96	83.52	5	10	1309	3387
Dcitr12g09390.1.1	460	23	483	Q8IPS6_DROME	464	10	474	0.0	70.968	94	83.66	2	4	675	1742
Dcitr12g09390.1.1	447	36	483	A8JNX2_DROME	451	96	547	0.0	73.009	92	84.73	2	4	674	1740
Dcitr12g09390.1.1	447	36	483	Q7KTU2_DROME	451	133	584	0.0	73.009	92	84.73	2	4	673	1737
Dcitr12g09890.1.1	124	4	128	KAPR1_DROME	124	252	376	2.40e-69	82.400	97	88.00	0	0	212	539
Dcitr12g09900.1.1	100	5	105	KAPR1_DROME	102	112	214	2.88e-54	83.495	83	90.29	1	2	173	438
Dcitr12g09910.1.1	132	9	141	KAPR1_DROME	132	244	376	2.36e-71	78.947	94	85.71	0	0	218	554
Dcitr12g10400.1.1	69	1	70	KISH_DROME	69	1	70	1.22e-27	75.714	97	82.86	0	0	94.4	233
Dcitr12g10440.1.1	69	1	70	KISH_DROME	69	1	70	1.22e-27	75.714	97	82.86	0	0	94.4	233
Dcitr13g01590.1.1	341	484	825	A0A0B4LFI7_DROME	341	941	1282	2.32e-162	73.199	83	81.56	3	10	505	1300
Dcitr13g01600.1.1	208	5	213	A0A0B4LFI7_DROME	208	1074	1282	3.23e-127	85.646	98	91.39	0	0	387	995
Dcitr13g01600.1.1	204	9	213	A8DWJ8_DROME	204	1136	1340	7.57e-125	85.854	96	92.20	0	0	382	981
Dcitr13g01600.1.2	341	117	458	A0A0B4LFI7_DROME	341	941	1282	1.06e-165	71.470	75	80.12	2	10	499	1286
Dcitr13g01720.1.1	116	1	117	RS9_DROME	121	1	122	1.78e-67	85.246	99	89.34	1	5	201	510
Dcitr13g02110.1.1	416	1	417	SCN60_DROME	416	1777	2193	0.0	89.209	97	94.24	0	0	769	1987
Dcitr13g02590.1.1	129	1	130	Q9W1C6_DROME	129	95	224	1.12e-66	71.538	82	91.54	0	0	202	513
Dcitr13g02680.1.1	251	20	271	RL7A_DROME	251	18	269	8.00e-130	73.016	92	86.11	0	0	368	945
Dcitr13g02890.1.1	271	6	277	Q9V3D1_DROME	272	12	284	1.18e-163	76.557	98	88.64	1	1	455	1170
Dcitr13g02890.1.1	270	6	276	Q8IP67_DROME	271	12	283	1.71e-163	77.206	97	88.60	1	1	454	1169
Dcitr13g02890.1.1	269	6	275	X2JAD3_DROME	270	12	282	3.30e-162	77.122	97	88.56	1	1	452	1162
Dcitr13g03010.1.1	230	29	259	M9PC40_DROME	232	72	304	7.89e-138	78.541	86	90.13	1	2	393	1009
Dcitr13g03010.1.1	230	29	259	X2J8X8_DROME	238	72	310	2.77e-135	76.569	86	87.87	2	8	387	993
Dcitr13g03010.1.1	210	29	239	Q9VT76_DROME	210	72	282	4.41e-131	81.517	78	91.94	0	0	372	954
Dcitr13g03190.1.1	211	1	212	O18333_DROME	212	1	213	2.31e-144	90.610	99	94.37	1	1	400	1028
Dcitr13g03190.1.1	211	1	212	Q9U5D5_DROME	212	1	213	2.95e-143	90.141	99	94.37	1	1	397	1020
Dcitr13g03330.1.1	198	16	214	O18333_DROME	196	3	199	4.03e-130	89.552	88	91.54	2	6	365	936
Dcitr13g03330.1.1	198	16	214	Q9U5D5_DROME	196	3	199	2.74e-129	89.055	88	91.54	2	6	362	930
Dcitr13g03720.1.1	1105	1	1106	E6EK15_DROME	1170	1	1171	0.0	70.111	99	79.76	8	65	1646	4262
Dcitr13g03720.1.1	802	306	1108	Q59DP9_DROME	822	343	1165	0.0	74.605	95	85.91	4	20	1294	3349
Dcitr13g03720.1.1	266	1	267	Q59DP9_DROME	268	1	269	1.37e-127	80.297	95	86.99	1	2	420	1080
Dcitr13g03720.1.1	800	306	1106	Q59DQ0_DROME	817	343	1160	0.0	73.716	95	84.96	4	17	1268	3281
Dcitr13g03720.1.1	266	1	267	Q59DQ0_DROME	268	1	269	3.85e-128	80.297	95	86.99	1	2	420	1080
Dcitr13g03720.1.2	1105	1	1106	E6EK15_DROME	1170	1	1171	0.0	70.111	99	79.76	8	65	1646	4262
Dcitr13g03720.1.2	802	306	1108	Q59DP9_DROME	822	343	1165	0.0	74.605	95	85.91	4	20	1294	3349
Dcitr13g03720.1.2	266	1	267	Q59DP9_DROME	268	1	269	1.37e-127	80.297	95	86.99	1	2	420	1080
Dcitr13g03720.1.2	800	306	1106	Q59DQ0_DROME	817	343	1160	0.0	73.716	95	84.96	4	17	1268	3281
Dcitr13g03720.1.2	266	1	267	Q59DQ0_DROME	268	1	269	3.85e-128	80.297	95	86.99	1	2	420	1080
Dcitr13g04130.1.1	302	14	316	WDS_DROME	302	59	361	0.0	96.040	96	98.35	0	0	603	1554
Dcitr13g04330.1.1	533	1	534	Q8IGN0_DROME	533	1	534	0.0	76.262	99	87.48	2	2	846	2186
Dcitr13g04330.1.1	533	1	534	Q8T6I0_DROME	533	1	534	0.0	76.075	99	87.48	2	2	846	2186
Dcitr13g04330.1.1	527	7	534	Q8T8W3_DROME	528	12	540	0.0	76.371	98	87.52	1	1	843	2177
Dcitr13g04330.1.2	533	1	534	Q8IGN0_DROME	533	1	534	0.0	76.262	99	87.48	2	2	846	2186
Dcitr13g04330.1.2	533	1	534	Q8T6I0_DROME	533	1	534	0.0	76.075	99	87.48	2	2	846	2186
Dcitr13g04330.1.2	527	7	534	Q8T8W3_DROME	528	12	540	0.0	76.371	98	87.52	1	1	843	2177
Dcitr13g04450.1.1	353	1	354	GNAO_DROME	353	1	354	0.0	94.068	99	96.89	0	0	679	1751
Dcitr13g04450.1.1	353	1	354	GNAO_MANSE	354	1	355	0.0	89.607	99	94.38	3	3	659	1700
Dcitr13g04480.1.1	248	1	249	GNAO_DROME	248	106	354	0.0	95.582	99	97.59	0	0	505	1300
Dcitr13g04480.1.1	248	1	249	GNAO_MANSE	249	106	355	1.47e-175	93.625	99	96.81	3	3	486	1251
Dcitr13g04480.1.1	231	18	249	GNAI_DROME	232	123	355	1.81e-123	72.103	93	81.97	1	1	354	909
Dcitr13g04510.1.1	229	15	244	GNAO_DROME	229	19	248	6.54e-159	91.739	92	95.65	0	0	444	1142
Dcitr13g04510.1.1	242	2	244	GNAO_MANSE	243	6	249	2.60e-157	86.475	97	93.03	1	1	440	1131
Dcitr13g04580.1.1	214	1	215	RAN_DROME	215	1	216	1.88e-151	90.741	99	96.76	1	1	418	1075
Dcitr13g04730.1.1	157	19	176	PNUT_DROME	158	367	525	4.34e-65	71.698	84	84.28	1	1	208	529
Dcitr13g05080.1.1	164	1	165	Q9W1B9_DROME	164	1	165	7.06e-94	79.394	99	87.88	0	0	268	686
Dcitr13g05080.1.2	164	1	165	Q9W1B9_DROME	164	1	165	7.06e-94	79.394	99	87.88	0	0	268	686
Dcitr13g05080.1.3	164	1	165	Q9W1B9_DROME	164	1	165	7.06e-94	79.394	99	87.88	0	0	268	686
Dcitr13g05080.1.4	164	1	165	Q9W1B9_DROME	164	1	165	7.06e-94	79.394	99	87.88	0	0	268	686
Dcitr13g05110.1.1	289	1	290	GOLP3_DROME	293	1	294	5.94e-151	70.707	99	83.50	3	10	423	1088
Dcitr13g05280.1.1	139	1	140	RL23_DROME	139	1	140	5.14e-94	93.571	99	97.14	0	0	267	682
Dcitr13g05350.1.1	547	1	548	ATPA_DROME	551	1	552	0.0	85.326	99	93.12	1	4	967	2501
Dcitr13g05370.1.1	769	1	770	TERA_DROME	758	43	801	0.0	84.935	99	91.82	4	11	1346	3484
Dcitr13g05690.1.1	390	7	397	SRC42_DROME	389	128	517	0.0	89.258	98	93.35	1	1	724	1868
Dcitr13g05890.1.1	343	3	346	MK14A_DROME	346	8	354	0.0	78.098	95	87.90	1	3	579	1492
Dcitr13g05890.1.1	354	1	355	MK14B_DROME	357	5	362	0.0	74.302	98	85.20	1	3	577	1487
Dcitr13g05890.1.2	352	1	353	MK14B_DROME	357	5	362	0.0	71.788	98	83.24	2	5	554	1427
Dcitr13g05890.1.2	341	3	344	MK14A_DROME	346	8	354	0.0	74.928	95	85.30	2	5	549	1414
Dcitr13g06310.1.1	89	623	712	ZN423_DROME	89	174	263	1.80e-34	71.111	85	82.22	0	0	143	361
Dcitr13g06310.1.1	89	623	712	A0A0B4JD76_DROME	89	312	401	2.06e-34	71.111	79	82.22	0	0	143	361
Dcitr13g06750.1.1	75	1	76	Q8MLQ0_DROME	75	1	76	4.82e-44	84.211	99	90.79	0	0	135	341
